子供{{c1::あっての}}我が家、子供がいなかったら、即離婚だな。	あっての<br>あればの<br>あったの<br>あるべき
主婦のパートだったら、時給７００円から１０００円{{c1::といったところ}}が相場だろう。	といったところ<br>といったこと<br>としたこと<br>としたところ
彼は噂によると１億5千万円{{c1::からの}}借金を抱えているという。	からの<br>にたる<br>にまして<br>ゆえの
冬の厳しいこの地方でも、雪がとけ始め、あたりもようやく春{{c1::めいてきた}}。	めいてきた<br>どおりだ<br>づいてきた<br>っぽい
あの店{{c1::ときたら}}サービスが悪くて……。味だけは一流なんだけどね。	ときたら<br>としたら<br>として<br>ときて
冬は人通りが少なく寂しい限りだが、春{{c1::ともなると}}、花見客でにぎわうようになる。	ともなると<br>ともあれ<br>ともすると<br>ともなれ
漢字は{{c1::おろか}}ひらがなも書けないなんて！	おろか<br>きわみ<br>かぎり<br>あげく
私がお見合いしようと{{c1::するまい}}と、あなたには関係ありません。	するまい<br>せざる<br>したい<br>したがらざる
彼女は仕事をする{{c1::かたわら}}独学で英語を学び、英検１級に合格した。	かたわら<br>あまり<br>うちに<br>そばから
こんな夜中に電話してくるなんて、非常識{{c1::極まりない}}。	極まりない<br>極めている<br>極まらない<br>極まっている
学生あての荷物が学校に届いたが、夏休み中の{{c1::こととて}}連絡がとれなかった。	こととて<br>ことさせ<br>ことでは<br>ことに
上から下まで黒{{c1::ずくめで}}妙な人物が家の前をうろうろしていたのでびっくりした。	ずくめで<br>ぐらいで<br>めいて<br>ぼっちで
やるだけのことはやった。あとは、合格通知を待つ{{c1::のみ}}だ。	のみ<br>ほど<br>きり<br>すら
東京に家を建てるためだ。節約、節約、1円{{c1::たりとも}}むだづかいはできない。	たりとも<br>どころか<br>ならでは<br>までも
彼女がこのクラスに{{c1::入って}}からというもの、雰囲気が一変した。	入って<br>入った<br>入る<br>入らない
10年に一度のお祭り{{c1::とあって}}、村は見物客でにぎわった。	とあって<br>にあたって<br>として<br>にして
まさか……あのテレビのアナウンサーがガンだった{{c1::とは}}、知らなかった。	とは<br>にすら<br>わけに<br>ものを
可能性がないとは言わない{{c1::まで}}も、限りなくゼロに近いね。	まで<br>から<br>ばかり<br>すら
これこそ日本の味だ。日本{{c1::ならでは}}の独特の風味がある。	ならでは<br>であれ<br>らしき<br>ごとき
妻が離婚を決意する{{c1::にいたって}}、初めて夫は自分の非に気づいた。	にいたって<br>について<br>にひきかえ<br>に際して
たかが不合格だとは思っても、「死にます」って手紙に書いてあったんだ。命に{{c1::かかわる}}ことなんだ。ほっておけないよ。	かかわる<br>いたる<br>あたる<br>かわる
勉強家の弟{{c1::にひきかえ}}、兄は遊んでばかりいる。	にひきかえ<br>はもとより<br>とはいえ<br>とともに
大人気だった第一回目のコンサートにも{{c1::まして}}、今回はチケット発売時から申し込みが殺到している。	まして<br>ひきかえ<br>いたって<br>あたって
あなたのためを思えば{{c1::こそ}}、こんなに厳しくいうのです。	こそ<br>から<br>すら<br>だけ
こんな簡単なことは、わざわざ先生にきく{{c1::までもなく}}、辞書をひけばわかります。	までもなく<br>わけもなく<br>はずもなく<br>ほどもなく
だれもが有名になりたがるが、有名である{{c1::がゆえの}}悩みというものもある。	がゆえの<br>かわりの<br>ごとくの<br>だけの
きみの実力を{{c1::もって}}すれば、日本語能力試験など恐れるにたりない。	もって<br>とって<br>かぎりに<br>ように
まわりの人々の忠告{{c1::をよそに}}、わがままを通してきた彼ももうすぐ人の親になる。	をよそに<br>はもとより<br>はやはり<br>をかぎりに
課長のSは、策略家で、社長に{{c1::ならんがために}}、いろいろ裏工作をしていると聞く。	ならんがために<br>ならぬがために<br>なるまいがために<br>ならないがために
子どものけんかに親がわざわざ口出しをする{{c1::までもない}}。それぐらいのこと子ども同士で解決させろ。	までもない<br>までだ<br>ものだ<br>のもでもない
あの冷静なAさん{{c1::にして}}上がってしまうのだから、そうでない我々はどうなることか。	にして<br>だから<br>こそ<br>なのに
ファミコンにかけては、子ども{{c1::といえども}}、バカにはできない。	といえども<br>といったが<br>といって<br>というなら
うちの母親におかずが少ないとか、まずいとか{{c1::言った}}が最後、つぎから食事は作ってもらえない。	言った<br>言って<br>言う<br>言わない
主婦は、夫と子どもを残して、旅行で3日も家をあけると、家の中がどうなっているか、{{c1::想像する}}だに恐ろしいという。	想像する<br>想像できる<br>想像せず<br>想像せぬ
友人が病院に運ばれたときいたときは、もうだめかと思ったが、かろうじて命だけは{{c1::たすかったようだ}}。	たすかったようだ<br>たすかるしまった<br>たすかるにあたらなかった<br>たすかるわけだ
強引で一方的なところがある彼は、人の話をろくに{{c1::きこうとしない}}。	きこうとしない<br>きくべきではない<br>ききようがない<br>きかないわけにはいかない
あなたを心配しているからこそ、わたしはあなたに、厳しく注意する{{c1::のです}}。	のです<br>はずです<br>ものです<br>ことです
通信販売に人気が集まっている。確かに便利なものであるとはいえ、実際に品物を見ないことには、{{c1::安心できそうもない}}。	安心できそうもない<br>安心するかぎりだ<br>安心するにはあたらない<br>安心してやまない
全員合格を目指してがんばったが、実際に合格できたのは50％{{c1::に過ぎなかった}}。	に過ぎなかった<br>を過ぎた<br>まで過ぎた<br>しか過ぎなかった
旅行に行って、少しのんびりしたいと思うが、会社が休みをくれないのでは、行きたくても{{c1::行きようがない}}。	行きようがない<br>行かないではいられない<br>行かざるをえない<br>行かずにはすまない
もぎたてのブドウは本当においしい。これほどのおいしさは、産地ならでは{{c1::味わえない}}。	味わえない<br>味わうばかりだ<br>味わいかねない<br>味わうことができる
「ミスをなくせ」と言われても、機械ではあるまいし、完璧な仕事は、そう簡単に{{c1::できるものではない}}。	できるものではない<br>できるつもりはない<br>できないものでもない<br>できないつもりはない
冗談が好きでいつもみんなを笑わせてくれる彼だが、少し冗談が{{c1::過ぎるきらいがある}}。	過ぎるきらいがある<br>過ぎるにたえない<br>過ぎないまでのことだ<br>過ぎないものがある
優しくて冷静な彼といえども、場合によっては感情的な反応を{{c1::示すこともある}}。	示すこともある<br>示しつつある<br>示すまい<br>示さんばかりである
不況が続く中、どの会社も生き残るために必死である。しかし、社員{{c1::あっての}}会社なのだから、社員に負担をかけるようなことは、できるだけ避けなければならない。	あっての<br>ずくめの<br>まみれの<br>かぎりの
今の情報化社会では、メディアを通してさまざまな体験ができるようになった。だからこそ、実際に{{c1::身をもって}}体験することの重要性も増してきている。	身をもって<br>身をおいて<br>身をものともせず<br>身をよそに
なぜ、彼女はわたしに相談してくれなかったのだろう。わたしに相談してくれさえすれば、いくらでも力になった{{c1::ものを}}。彼女の立場を思うと分からないでもないが、いまさらながら、悔やまれる。	ものを<br>ものだ<br>ものの<br>ものか
消費税を廃止しろと言う人がいる。しかし、歴史を後戻り{{c1::させるべきではない}}。むしろ、所得税をすべて消費税に切り替えることの方が、現在の消費社会に適していて現実的だ。	させるべきではない<br>させるしかない<br>させないわけがない<br>させないではすまない
知人のK氏は、日本の大都市で暮らしながら、毎年、母国から来日する留学生の世話をしている。自分の仕事をもちながら苦労して後輩のめんどうを見るのは、彼自身、かつて留学生だった{{c1::からにほかならない}}。後輩を育てることが、現在の彼の生きがいである。	からにほかならない<br>よりほかにない<br>からにはしかたがない<br>ことになっている
今、思い出してみると、学生時代は本当にのんびりしていた。それが、就職して社会の一員に{{c1::なってからといもの}}、ほとんど自分の生活をふりかえる余裕もなく、仕事に追われる毎日となってしまった。	なってからといもの<br>なったそばから<br>なろうものなら<br>なってからでないと
確かに計画が失敗した責任は彼にある。だからといって、人の悪口を、その人のいないところで{{c1::言うものではない}}。人のことを悪く言えば、必ずその言葉は自分に返ってくるからである。	言うものではない<br>言わないものではない<br>言わずにはおかない<br>言わざるをえない
なぜ「いじめ」のような事件が起きるのであろうか。いろいろ議論は{{c1::あるにせよ}}学校の内部だけの問題でないことは確かである。	あるにせよ<br>あるのみならず<br>あるまでもなく<br>あるかわりに
あの戦争から50年以上がたつというのに、今も世界のあちこちで争いが絶えない。地球全体が病気にかかっているようで、将来を{{c1::心配せずにはいられない}}。	心配せずにはいられない<br>心配するものではない<br>心配するべきではない<br>心配せずにはおかない
人間は社会的な動物であり、特に現代の情報社会では社会を意識しないでは生きて行けない。しかし、人が何と{{c1::言おうと}}、絶対に変わらない強い意志も必要である。	言おうと<br>言うまじき<br>言いながらも<br>言うまいと
天候に{{c1::かかわらず}}明日は遠足に行きます。	かかわらず<br>よると<br>よれば<br>かかわり
子ども達は動物園に着くが{{c1::はやいか}}おやつを食べ出した。	はやいか<br>はやるか<br>はやくて<br>はやめて
試験の結果を{{c1::もとにして}}クラス分けを行います。	もとにして<br>もとづいて<br>かぎりにして<br>めぐって
帰国のあいさつ{{c1::かたがた}}おみやげを持って先生のお宅を訪問した。	かたがた<br>がらみに<br>かねて<br>がために
彼は学生として許す{{c1::べからざる}}行為を行ったとして退学させられた。	べからざる<br>べき<br>べく<br>べからず
卒業生の健康と幸せを願って{{c1::やまない}}。	やまない<br>そういない<br>とまらない<br>すまない
今日は朝からいいこと{{c1::ずくめで}}幸せな気分だ。	ずくめで<br>よりで<br>あふれて<br>かぎりで
原子力発電所の建設に{{c1::あたって}}住民との話し合いがもたれた。	あたって<br>わたって<br>かけて<br>うけて
あのレストランの料理は量{{c1::といい　といい}}味{{c1::といい　といい}}文句のつけようがない。	といい　といい<br>をよそに　をよそに<br>をかね　をかね<br>とに　とに
駅前のスーパーまで散歩{{c1::がてら}}買い物に行った。	がてら<br>につれて<br>にともなって<br>かたわら
犯人は買い物をしていた{{c1::ところを}}警官に逮捕された。	ところを<br>ところに<br>あいだ<br>そばから
列にわりこむなど紳士にある{{c1::まじき}}行為だ。	まじき<br>まい<br>らしい<br>べき
ああでもない、こうでもないと迷惑をかけたあげく、あの{{c1::しまつだ}}。	しまつだ<br>かぎりだ<br>しまいだ<br>おわりだ
十代の娘じゃ{{c1::あるまいし}}そんなはでなリボンはつけられませんよ。	あるまいし<br>ありそうに<br>ありながら<br>あるほどに
風呂の水を{{c1::だしっぱなしにして}}出かけてしまった。	だしっぱなしにして<br>だしにして<br>だしつつ<br>だしおいて
あの患者は重い病気のため、一人では食事{{c1::すらできない}}。	すらできない<br>せしめるほどだ<br>だにとっている<br>せずにはおかない
今年の米は温暖な気候と適度な雨量とが{{c1::あいまって}}豊作となった。	あいまって<br>あざむいて<br>あてがって<br>あたいして
動物保護に{{c1::かかわる}}重要な環境問題について真剣に議論した。	かかわる<br>おうして<br>よって<br>まもる
彼が秘密を外部にもらしたことは想像に{{c1::かたくない}}。	かたくない<br>こえる<br>かたい<br>こえない
国防費を{{c1::かわきりに}}種々の予算が見直され始めた。	かわきりに<br>ばかりに<br>あっての<br>みなして
任務{{c1::とはいえ}}あの南極で長い冬を過ごすのは大変なことだろう。	とはいえ<br>とばかりに<br>といえば<br>ともなく
今回の出版に関してご配慮をたまわり感謝に{{c1::たえません}}。	たえません<br>やむをえません<br>こたえません<br>そえません
他の人にとって厳しいトレーニングでも、あの運動は山田さんにとってはちょうどいい散歩{{c1::といったところだ}}。	といったところだ<br>といったかもしれない<br>といえばこそだ<br>というにはあたらない
彼女の今までの苦労を知っているので、留学が決まったときあれほど喜んだ気持ちが{{c1::わからないでもない}}。	わからないでもない<br>わからなかった<br>わかるものではない<br>わかったものではない
あの作家は天才なのだから、わずか３日で傑作を書いたからといって、驚く{{c1::にはあたらない}}。	にはあたらない<br>べきことだ<br>にきまっている<br>にちがいない
毎日遅刻せずに会社に来るとはいえ、その仕事ぶりは{{c1::ひどいといったらない}}。	ひどいといったらない<br>ひどいわけではない<br>ひどくはなかった<br>ひどいはずがない
話をおもしろくするためだろうか、あの人はものごとを大げさに言う{{c1::きらいがある}}。	きらいがある<br>きらいではない<br>きらいらしい<br>きらいがない
勉強よりまず健康のことを考えるべきだ。試験に合格しても、病気になってしまったら{{c1::それまでだ}}。	それまでだ<br>それからだ<br>それほどだ<br>それのみだ
息子は一流の音楽家になるといって家を出た。大変だが、きっと目的を達成せずには{{c1::おかないだろう}}。	おかないだろう<br>おくことはない<br>おいてあった<br>おくべきではない
悪条件を{{c1::ものともせず}}、参加者全員が見事にゴールインした。	ものともせず<br>ものとして<br>ものならず<br>ものながら
朝起きてまずお茶を飲むことが習慣になっている。お茶{{c1::なしには}}一日が始まらない。	なしには<br>なければ<br>ないので<br>ないのに
年を取るに{{c1::つれて}}私も父親に言われたことと同じことを自分の子どもに言うようになってきた。	つれて<br>そって<br>ひきかえ<br>しても
何ヶ月も前から準備してきたからには失敗{{c1::するはずがない}}と思うが、不安が残る。	するはずがない<br>せざるをえない<br>するかもしれない<br>せずにはいられない
おくびょうで{{c1::あればこそ}}、用心深くなり、危険を避けることができるのだ。	あればこそ<br>あるがまま<br>ありえず<br>あってさえ
あの名人も初めからこんなに仕事ができたわけではない。若いころは、先輩のやることを見て、できない{{c1::ながらも}}その真似をしていたのだった。	ながらも<br>つつも<br>たりとも<br>からでも
太陽と{{c1::いえども}}永遠に輝いているわけではない。いつかは消え去るときがくる。	いえども<br>いったらば<br>いえばこそ<br>いったからには
彼の栄光は、きびしいレースを勝ち{{c1::ぬいた}}末に獲得したものだ。	ぬいた<br>ぬく<br>ぬいて<br>ぬき
小さい頃、よく泥{{c1::まみれ}}になって弟とけんかをしたものだ。	まみれ<br>ずくめ<br>ばかり<br>みずく
喫茶店で、となりの席の話を聞く{{c1::ともなしに}}聞いていたら、私の会社のことだったので驚いた。	ともなしに<br>のみならず<br>ばかりか<br>どころではなく
子どものころ、死については{{c1::考える}}だに恐ろしかった。	考える<br>考えた<br>考えて<br>考え
あの時もっとがんばっていれば、と後悔してみた{{c1::ところ}}で、今更しようがない。	ところ<br>もの<br>こと<br>の
あの人は話好きで、目が{{c1::あったが}}最後、最低30分は放してくれない。	あったが<br>あったの<br>あうのに<br>あったから
他人を犠牲にする{{c1::こと}}なしに、個人の望みを達成することは困難だと考えている人もいます。	こと<br>の<br>もの<br>ところ
あそこの家の父親は、毎日朝から酒を飲んで暴れている。息子は仕事もせず賭事に夢中になっている。まったく、父も父{{c1::なら}}子も子だ。	なら<br>では<br>と<br>にして
「考えてみます」と言われたので、了承されたと{{c1::思いきや}}、実はそれは「お断りします」という意味だった。	思いきや<br>思っても<br>思ったり<br>思いゆえ
この困難な任務を果たせるのは、彼{{c1::を}}おいてほかにはいない。	を<br>は<br>に<br>で
環境問題の解決策を{{c1::めぐって}}、熱心な議論が続いている。	めぐって<br>通じて<br>まわって<br>こめて
この問題については、あなた{{c1::なりの}}お考えがおありでしょうが、ここのところは私の言うとおりにしてください。	なりの<br>なみの<br>次第の<br>向きの
その赤ん坊は、私が抱きあげたら今にも泣き{{c1::出さん}}ばかりの顔をした。	出さん<br>出さ<br>出す<br>出した
彼はとても忙しいらしい。食事を{{c1::とる}}が早いか、すぐに飛びだしていった。	とる<br>とり<br>とって<br>とろう
詳しくお話を{{c1::うかがって}}からでないと、お答えできません。	うかがって<br>うかがう<br>うかがった<br>うかがい
自分のことだけではなく、相手の立場に立って考えることのできる人、それが大人という{{c1::もの}}だ。	もの<br>ひと<br>ほう<br>ところ
彼は読書が好きだが、読んだそば{{c1::から}}何を読んだか忘れてしまい、同じ本を何冊も買ってしまう。	から<br>で<br>に<br>まで
経済問題の解決には、政府や企業の対応もさること{{c1::ながら}}、消費者の態度も重要な要素となる。	ながら<br>であり<br>でなく<br>とともに
徹夜は{{c1::しないまでも}}、せめて夜１２時くらいまでは勉強したほうがいいいんじゃないですか。	しないまでも<br>するまでも<br>しないほどで<br>するほどで
とにかく事故現場をこの目で{{c1::見ない}}ことには、対策はたてられません。	見ない<br>見る<br>見た<br>見なかった
チンパンジーは人間の模倣を{{c1::する}}のみならず、互いに協力して共同作業をしているらしいという報告もある。	する<br>して<br>せず<br>しまい
実際に読んでみて{{c1::はじめて}}、古典のおもしろさを知った。	はじめて<br>はじめで<br>はじめ<br>はじめると
半導体に対する需要は、ここ数年、以前{{c1::に}}もまして高まっている。	に<br>から<br>で<br>まで
お世話になった先生に頼まれた{{c1::からには}}、ことわるわけにはいかない。	からには<br>からでは<br>までには<br>まででは
「これが最近書いた本なんですが、あなたにさしあげますから、どうぞお読みください。」「はい、{{c1::拝見させて}}いただきます。」	拝見させて<br>ご覧になって<br>拝見して<br>ご覧にならせて
「先生の奥様はどの方かご存じですか。」「あそこの{{c1::お年}}を召していらっしゃるご婦人です。」	お年<br>年<br>年齢<br>お年齢
帰国する日にパスポートをホテルに置き忘れてくるなんて、いかにも彼の{{c1::やりそうなことだ}}。	やりそうなことだ<br>やりたいことだ<br>やるべきことだ<br>やるらしいことだ
不景気になってからというもの、長年、会社に貢献してきた人でさえ、会社を{{c1::やめさせられている}}。	やめさせられている<br>やめられないですむ<br>やめさせるまでもない<br>やめないではおかない
運転手が教えてくれたからよかったものの、もう少しで大切な卒業論文をタクシーの中に{{c1::忘れるところだった}}。	忘れるところだった<br>忘れるところだろう<br>忘れないところだった<br>忘れるところではなかった
彼が生活に困っているというから、お金を貸したのに、そのまま姿を消してしまい、今となっては{{c1::あきらめるよりほかない}}　。	あきらめるよりほかない<br>あきらめかねない<br>あきらめるまでもない<br>あきらめきれない
慎重なあの人に限って、そんなミスを{{c1::おかすはずがない}}。	おかすはずがない<br>おかしてばかりいる<br>おかさないではいられない<br>おかそうとしている
苦難に満ちたあの人の人生は、涙なくしては{{c1::語れない}}。	語れない<br>語らない<br>語れる<br>語る
信じられないことだが、これだけ証拠があがっているのだから、事実{{c1::に相違ない}}。	に相違ない<br>に決まっていない<br>にちがわない<br>にことならない
もう少し考える時間をくれれば、やら{{c1::ないこともない}}。	ないこともない<br>なければならない<br>ないこともある<br>ずにはいられない
私だけが悪いのではないのに、みんなが私一人が悪いと言ったので、くやしく{{c1::てならない}}。	てならない<br>てなるべきだ<br>てならなくない<br>てなればいい
彼が自分でやると言ったのだから、忙しいあなたがなにもてつだう{{c1::ことはない}}。	ことはない<br>ことだ<br>ことにした<br>こともある
勉強第一と言っても、勉強時間が長ければいい{{c1::というものではない}}。	というものではない<br>というわけだ<br>といえばいい<br>というものだ
したい、したくない、という気持ちの問題ではない。公言した以上、せ{{c1::ざるをえない}}のだ。	ざるをえない<br>ざらなければならない<br>ずをえない<br>ずのえない
人を信用させるには、うそをつかない{{c1::ことだ}}。	ことだ<br>わけだ<br>ほうだ<br>ぐらいだ
この学校では学生が教室をそうじする{{c1::ことになっている}}。	ことになっている<br>ことにきめかねない<br>ことにならない<br>ことにきめられた
これ以上大きな地震は、あと100年は起こる{{c1::まい}}。	まい<br>はず<br>わけ<br>こと
こんな難しい問題、君なんかにできっ{{c1::こない}}。	こない<br>たっけ<br>ない<br>そう
欲しくて{{c1::たまらない}}カメラがあるが、高くて、手に入れられない。	たまらない<br>がまんする<br>ならない<br>たえられない
こんな大金、親が貸してくれる{{c1::わけはない}}。	わけはない<br>わけではない<br>つもりはない<br>たとえはない
うわさ話をみんなに{{c1::話したくて}}しようがない。	話したくて<br>話したいので<br>話したところ<br>話したがって
9月から、私鉄、地下鉄の運賃が値上げされる{{c1::ということだ}}。	ということだ<br>といえなくもない<br>といえるだろう<br>ということになった
会社を首になり、不況で次の仕事もみつからず、親からの借金は増える{{c1::一方だ}}。	一方だ<br>ましだ<br>片方だ<br>両方だ
子どもは親の言うことを聞く{{c1::ものだ、ものではない}}。親に逆らう{{c1::ものだ、ものではない}}。	ものだ、ものではない<br>はずだ、はずではない<br>わけだ、わけではない<br>ことだ、ことではない
そんな自分勝手なことが、社会に通る{{c1::わけはない}}。	わけはない<br>ことはない<br>つもりはない<br>たとえはない
人の気も知らないで、もうあんなやつのことなんか、心配してやる{{c1::ものか}}。	ものか<br>ぐらいか<br>ほどか<br>ことか
さあ、元気を出して、今度こそ、優勝してみせ{{c1::ようではないか}}。	ようではないか<br>ましょうか<br>るでしょうか<br>るべきでしょうか
日本では、いいことが重なって起きると、「盆と正月がいっしょにやってきた{{c1::かのようだ}}」と言う。	かのようだ<br>とみたいだ<br>といえるだろう<br>かとらしい
この病気は感染する{{c1::おそれ}}があるので、すぐ隔離してください。	おそれ<br>ため<br>わけ<br>もの
彼のほうが悪いんだから、きみが謝る{{c1::ことはない}}。	ことはない<br>ことだ<br>ことにした<br>こともある
用事があって電話{{c1::したところ}}、留守だった。	したところ<br>しているところ<br>するところ<br>しようところ
先生が言った{{c1::とおりに}}勉強すれば、能力試験に合格できますよ。	とおりに<br>とともに<br>ところに<br>として
人生について考えすぎ{{c1::たあまり}}髪が薄くなった。	たあまり<br>たこそ<br>たさえ<br>たばかり
親にさんざん迷惑をかけ{{c1::たあげく}}、飛び降り自殺してしまった彼の人生は一体なんだったんだろう。	たあげく<br>たからは<br>たので<br>たはずで
展覧会が中止になった{{c1::うえは}}、この後の対策を至急考えなければならない。	うえは<br>からは<br>のにも<br>としても
留学{{c1::を契機に}}、生まれて初めて家族と離れ、一人暮らしをすることになった。	を契機に<br>を起点に<br>をはじめ<br>の際
私は彼が嫌いだ。ものの言い方{{c1::からして}}気に入らない。	からして<br>からは<br>からすると<br>からには
ベッドの上に寝た{{c1::きり}}だった病人が、起き上がれるようになった。	きり<br>から<br>のみ<br>とか
4月に入学し{{c1::て以来}}、１日も休んだことのないＡさんが１週間も顔を見せない。	て以来<br>て以内<br>て以上<br>て以外
悪いことをしても人に知られ{{c1::ないかぎり}}、黙っていれば大丈夫だと思っている人がいる。	ないかぎり<br>ないぐらい<br>ないから<br>ないほど
あの人は勉強しない{{c1::ばかりか}}、雑誌すら読もうとしない。	ばかりか<br>かぎりか<br>ほどか<br>までか
「あんたなんか、大嫌い」と言って別れた{{c1::ものの}}、時がたつにつれて、だんだん後悔しはじめた。	ものの<br>ものを<br>ものから<br>もので
急ぎの仕事が入った{{c1::ものだから}}、電話もできなくて、ごめん。	ものだから<br>ものの<br>ものを<br>ものだけれど
交通規則{{c1::にしたがって}}運転してください。	にしたがって<br>にさきだって<br>にこたえて<br>にともなって
都市の拡大{{c1::にともなって}}様々な問題が生じてきた。	にともなって<br>しなって<br>にしたがって<br>にくらべて
このドラマは実際に北海道で起きた事件{{c1::にもとづいて}}制作されたものである。	にもとづいて<br>に関して<br>について<br>に際して
あの客は店の品物にいろいろケチをつけて、その{{c1::あげく}}何も買わずに行ってしまった。	あげく<br>ため<br>はず<br>とおり
その湖の美しさ{{c1::と言ったら}}言葉では表現できないほどである。	と言ったら<br>を言えない<br>を言うより<br>を言い
留学生{{c1::にとって}}ビザは大切な問題だ。	にとって<br>について<br>にして<br>にかけて
人が外で待っているの{{c1::にもかまわず}}電話ボックスでながばなしをする若者がいる。	にもかまわず<br>にしても<br>につけ<br>だけに
家族も親戚も反対した{{c1::にもかかわらず}}若い二人はいっしょに暮らしはじめた。	にもかかわらず<br>にせよ<br>のもも<br>からには
どんな事情があった{{c1::にせよ}}すぐ結果を知らせるべきだ。	にせよ<br>につけ<br>にとって<br>にかぎり
手紙{{c1::にしろ、にしろ、}}電話{{c1::にしろ、にしろ、}}親には居場所くらい知らせるものだ。	にしろ、にしろ、<br>やら、やら<br>とか、とか<br>につけ、につけ
煮る{{c1::につけ、につけ}}焼く{{c1::につけ、につけ}}日本料理にしょうゆは欠かせない。	につけ、につけ<br>たり、たり<br>やら、やら<br>や、など
A大学を頂点{{c1::として}}大学のランク付けがされている。	として<br>となって<br>とかけて<br>とかんして
夜明け{{c1::とともに}}出発しましょう。	とともに<br>の際に<br>にかけて<br>につれて
姉は妹の結婚{{c1::をきっかけに}}お見合いにすることになった。	をきっかけに<br>を原因に<br>を起点に<br>をはじめ
オリンピック開催{{c1::を契機に}}経済的に発展していった。	を契機に<br>を期間に<br>を時期に<br>を起点に
私のかさとよく似ていた{{c1::ものだから}}、まちがって友だちのを持ってきてしまった。	ものだから<br>ものを<br>もの<br>ものだけれど
大学生{{c1::を中心に}}反政府活動がくりひろげられた。	を中心に<br>を中に<br>を最中に<br>を軸に
愛情{{c1::をこめて}}作ったケーキ。	をこめて<br>をつめて<br>をふくんで<br>を入れて
コンピューター{{c1::を抜きにして}}今の社会は考えられない。	を抜きにして<br>を考えずに<br>を省いて<br>を置かないで
１年{{c1::を通じて}}、ここの気候は温暖です。	を通じて<br>をかけて<br>をわたって<br>をこえて
テレビ{{c1::をはじめ}}いろいろなメディアに紹介されたおかげで店は繁盛した。	をはじめ<br>を中心に<br>のかわりに<br>のおかげで
実存する人物{{c1::をもとにして}}書かれた小説。	をもとにして<br>をもとでに<br>をもとから<br>をもって
子どものけんかに親が口を出すこと{{c1::からして}}おかしい。	からして<br>からで<br>からまで<br>からには
この参考書を読んでからでないとレポートは{{c1::書けない}}。	書けない<br>書ける<br>書く<br>書くこと
この筆跡{{c1::から見ると}}、本人は意思の強い者と思われる。	から見ると<br>から決めて<br>から思って<br>から書いて
残念な{{c1::ことに}}、今回の企画は中止しなければならなくなった。	ことに<br>ことから<br>ことなんだから<br>ことはない
こんな時間になっても帰らないと、心配症の母の{{c1::ことだから}}、きっと門を出たり入ったりしているだろう。	ことだから<br>はずだから<br>わけだから<br>ものだから
集合時間に遅れたと思って、急いで行った{{c1::ところ}}、何のことはない、まだだれも来ていなかった。	ところ<br>せいで<br>とたん<br>おかげで
就職後のことは{{c1::ともかく}}、まずどの会社に入るかだ。	ともかく<br>どうにか<br>ともども<br>どうにも
学生{{c1::のくせに}}、全然勉強しない。	のくせに<br>のおかげで<br>のせいで<br>のなりに
あの人、言うこと{{c1::のわりに}}、やることはねえ……。	のわりに<br>のせいで<br>のくせに<br>のよりは
孫たちが帰っ{{c1::たとたん}}、部屋の中は静かになった。	たとたん<br>たなり<br>やいなや<br>とおもいきや
さっきまで泣いていた{{c1::かと思ったら}}、もう笑っている。	かと思ったら<br>と思うと<br>と思うなら<br>かと思って
うちの息子は学校から帰ってきて、かばんを置いたか置かない{{c1::かのうちに}}、外へ飛び出して行った。	かのうちに<br>とたん<br>なりに<br>間に
その恥ずかしさ{{c1::と言ったら}}、顔から火が出るほどだった。	と言ったら<br>と言えない<br>と言うと<br>と言い、
このマンションすごいなあ。マンション{{c1::というより}}ヨーロッパのお城って感じだね。	というより<br>といって<br>んほうが<br>のほどが
冬{{c1::はもとより}}夏も人気がある屋内スキー場。	はもとより<br>はもとから<br>はもともと<br>はもとまで
その薬を飲んだ{{c1::とたんに}}、意識がなくなってしまった。	とたんに<br>からには<br>あげくに<br>最中に
有名になればなるほど、社会的な地位が上がるが、{{c1::反面}}プライバシーはなくなっていく。	反面<br>反対<br>反して<br>対して
発車{{c1::の際}}少々ゆれますので、ご注意ください。	の際<br>のおり<br>のころ<br>の末
苦労{{c1::の末}}やああっと栄光をつかんだ。	の末<br>の機<br>の時<br>の際
まじめな話ですからから、冗談{{c1::抜き}}でいきたいと思います。	抜き<br>ぬいて<br>抜く<br>抜かない
この頃、仕事で少々過労{{c1::気味}}なので、疲労回復の注射でも打ってもらえませんか。	気味<br>すぎ<br>がち<br>ばて
彼女のどこかさびし{{c1::げ}}な横顔にひかれる。	げ<br>さ<br>い<br>み
相手先の返事{{c1::次第で}}、この取り引きはだめになるかもしれない。	次第で<br>からして<br>によりて<br>間際で
出席簿{{c1::上は}}いることになっているが、まだ一度も顔を見たことがない。本当にうちの学生？	上は<br>下は<br>中は<br>面は
子どもの話をうそと知り{{c1::つつ}}、お金を渡す母であった。	つつ<br>まま<br>ても<br>たり
子どもだと思っていたが、もう17歳なのか。道理で最近、大人{{c1::っぽく}}なってきたと思ったよ。	っぽく<br>っぽいに<br>っぽいと<br>っぽに
外国人{{c1::むき}}アパートが少なく、借りるのが大変だ。	むき<br>むいて<br>むいた<br>むく
この自転車は背が高い人{{c1::むける}}のものなので、子どもの君にはまだ乗りこなせないよ。（無理だよ）	むける<br>むけ<br>むけだ<br>むく
人気女優の楽屋は、ファンからのプレゼント{{c1::やら、やら}}花束{{c1::やら、やら}}でうずまっていた。	やら、やら<br>から、にかけて<br>から、まで<br>につけ、につけ
準備ができ{{c1::次第}}出発します。よろしいですか。	次第<br>次第で<br>次第の<br>次第より
この写真を見る{{c1::たびに}}、なくなった母を思い出す。	たびに<br>たびたび<br>たびまで<br>たびから
考える{{c1::べき}}ことは二つ、まず家族のこと、それから自分の自由についてだ。	べき<br>わけ<br>はず<br>の
いままで毎日学校へ来ていたまじめなＡ子さんは、アルバイトを初めてから、学校を休み{{c1::がち}}で、みんな心配している。	がち<br>そう<br>らしい<br>よう
もう腹がたって、腹がたって、八つ裂きにしてもたりない{{c1::ぐらいだ}}。	ぐらいだ<br>ほうだ<br>ことだ<br>すぎる
私の飲み{{c1::かけ}}のコーラは？	かけ<br>つつ<br>きり<br>がち
考えて、考えて、考え{{c1::抜いた}}結果だ。	抜いた<br>抜き<br>抜いて<br>抜く
申しわけございません。当社の責任ですから、でき{{c1::うるかぎり}}のことはさせていただきます。	うるかぎり<br>えるかぎり<br>ないかぎり<br>えないかぎり
いろいろと考えた{{c1::末}}、やっぱり大学進学をあきらめることにした。	末<br>以上<br>次第<br>際
笑っては失礼だと思い{{c1::つつ}}、笑わずにはいられなかった。	つつ<br>につけ<br>がちに<br>きり
なぜテストをするかというと、テストがないととかく学生はなまけ{{c1::がち}}になるからだ。	がち<br>気味<br>ぐせ<br>げ
危ないところ{{c1::を}}彼に助けてもらった。	を<br>に<br>が<br>か
初めて一人きりで海外出張することになった。心細い{{c1::かぎり}}だ。	かぎり<br>だらけ<br>きり<br>のみ
交渉の結果{{c1::いかん}}で、今後の対応を検討する。	いかん<br>ばかり<br>だけ<br>関して
大学で日本語を勉強する{{c1::かたわら}}、子供たちに英語を教えている。	かたわら<br>がてら<br>ながら<br>かたがた
授業が{{c1::終わる}}が早いか、教室を飛び出した。	終わる<br>終わった<br>終わらない<br>終わって
黒{{c1::ずくめ}}の男が逃げていくのが見えた。	ずくめ<br>だらけ<br>まみれ<br>だけ
努力する{{c1::こと}}なしに成功はありえない。	こと<br>さえ<br>もの<br>の
彼は何でも大げさに{{c1::言う}}きらいがある。	言う<br>言わないの<br>言わない<br>言うの
このような大災害になるとは想像{{c1::だに}}しなかった。	だに<br>だけ<br>までも<br>限り
乗客の安全のためには一瞬{{c1::たりとも}}油断できない。	たりとも<br>だけ<br>までも<br>限り
変な男が家の前を行き{{c1::つ、つ}}戻り{{c1::つ、つ}}している。	つ、つ<br>たり、たり<br>とか、とか<br>や、や
たばこを{{c1::やめて}}からというもの、食欲も出てすっかり健康になった。	やめて<br>やめた<br>やめる<br>やめない
父は家族のために、苦労を{{c1::もの}}ともせずに働いてくれた。	もの<br>なん<br>ばかり<br>こと
授業をサボって遊びに行くなんて、学生にある{{c1::まじき}}ことだ。	まじき<br>らしい<br>みたい<br>たる
祖父の人生はつらいことばかりで、涙{{c1::なしには}}かたれない。	なしには<br>ないから<br>なければ<br>ないでは
何{{c1::にも}}ましてうれしかったのは、１０年ぶりに懐かしい友達に会えたことだ。	にも<br>か<br>でも<br>さえ
彼の能力{{c1::をもって}}しても、その問題は解決できなかった。	をもって<br>と相まって<br>に応じて<br>に至るまで
子供を{{c1::救わん}}がために、命を落とした。	救わん<br>救う<br>救って<br>救おう
彼は優秀だから試験に合格しても驚く{{c1::にはあたらない}}。	にはあたらない<br>にすぎない<br>ばかりだ<br>ほかはない
努力家の姉{{c1::にひきかえ}}、弟はなまけてばかりいる。	にひきかえ<br>とばかりに<br>とともに<br>といえども
仕事を片づける{{c1::そば}}から、次の仕事を頼まれて、休む暇もない。	そば<br>あと<br>こと<br>とき
子供は母親の姿を{{c1::見る}}なり、わっと泣き出した。	見る<br>見た<br>見ない<br>見て
彼は力持ちだ。５０キロ{{c1::からある}}石を軽々と持ち上げた。	からある<br>極まる<br>はおろか<br>までの
家族の期待を{{c1::よそに}}、弟は大学をやめて遊び暮らしている。	よそに<br>もとに<br>かまわず<br>さておき
政府は税制改革{{c1::を皮切りに}}、次々と不況対策を発表した。	を皮切りに<br>に関して<br>を限りに<br>に即して
彼は重い病気にかかり、歩くどころか{{c1::起きあがることすらできない}}。	起きあがることすらできない<br>起きあがるはずがない<br>起きあがることはできる<br>起き上がれないものでもない
いくら高い車を買っても、事故を起こせば{{c1::それまでだ}}。	それまでだ<br>それからだ<br>まだまだだ<br>これからだ
早く帰れと言わんばかりの顔をされては、{{c1::帰らざるをえない}}。	帰らざるをえない<br>帰ることはない<br>帰るまでもない<br>帰らないようだ
時間に正確な彼にして遅刻してきたのだから、{{c1::事故があったにちがいない}}。	事故があったにちがいない<br>事故があった<br>事故を余儀なくされた<br>事故になるかもしれない
彼は歌が上手だからカラオケが好きかと思いきや、{{c1::嫌いだそうだ}}。	嫌いだそうだ<br>毎日行っている<br>好きなはずだ<br>好きらしい
暮らしは豊かになったといわれているが、まだまだ{{c1::聞くにたえない}}悲惨な生活を強いられている貧しい人々がいることを忘れてはならない。	聞くにたえない<br>聞くにかたくない<br>聞きがたい<br>聞くにたる
試験までもう１週間しかないのだから、今ごろになって後悔したところで{{c1::どうにもならない}}。それなら最初からもっと努力すべきだったのだ。	どうにもならない<br>どうしよう<br>どうにかすべきだ<br>どうにでもなる
最近の子供は甘やかされているとよくいわれる。しかし、厳しくしつければしつけるほどよいというものではなく、{{c1::厳しくしながらも}}子供の意見を聞いてやることが大切だ。	厳しくしながらも<br>厳しくしついでに<br>厳しくするまでもなく<br>厳しくするべからず
あのレストランは{{c1::おいしさもさることながら}}、従業員の客に対する態度が丁寧で申し分ない。	おいしさもさることながら<br>おいしいとはいえ<br>おいしくないまでも<br>おいしいからには
世界のあちこちで環境汚染が進んでいる。これは人類{{c1::のみならず}}、すべての生物にとって重大な問題だ。	のみならず<br>ならではの<br>に至っては<br>限りの
インターネットの発展に伴って、世界のあらゆる場所で同時に情報を得ることができるようになった。コンピューター{{c1::なくしては}}現代社会は成り立たないと言っても過言ではない。	なくしては<br>があったところで<br>があるから<br>があるばかりか
ドアを{{c1::開け}}っぱなしにしないでください。	開け<br>開ける<br>開けた<br>開けて
祖母の病気は重く、ひとりで起きること{{c1::すら}}できなくなった。	すら<br>とは<br>こそ<br>ほど
産まれる子供が男{{c1::であれ、であれ}}女{{c1::であれ、であれ}}、「ひかる」という名を付けると決めている。	であれ、であれ<br>といい、といい<br>やら、やら<br>なり、なり
作物をだめにする害虫は、一匹{{c1::たりとも}}残さないように退治しよう。	たりとも<br>かぎりは<br>ばかりか<br>ならでは
旅行{{c1::がてら}}、日本にいる息子の様子を見てこようと思っている。	がてら<br>かねて<br>ながら<br>つつ
徹夜をして企画書を作った{{c1::ところで}}、私などの企画が通るはずはない。	ところで<br>ところを<br>ところが<br>ところ
これは私が愛して{{c1::やまない}}作家の最高傑作だ。	やまない<br>しょうがない<br>ならない<br>すまない
留学経験の長い彼{{c1::ならではな}}国際感覚にあふれた意見だ。	ならではな<br>にあたって<br>たる<br>と相まって
毎日、汗{{c1::まみれ}}になって働いている。	まみれ<br>だけ<br>ずくめ<br>がち
彼は来るなと{{c1::言わん}}ばかりに手を振った。	言わん<br>言うが<br>言って<br>言わざる
全員を納得させる{{c1::にたる}}説明をするのは難しい。	にたる<br>にたえる<br>とする<br>ゆえの
子供では{{c1::あるまいし}}、自分のことぐらい自分でしなさい。	あるまいし<br>あれ<br>あろうが<br>なくて
彼は政治家{{c1::にあるまじき}}発言をして、辞任を迫られている。	にあるまじき<br>になるべく<br>なりの<br>ながらに
親は自分のこと{{c1::にも}}まして、子供のことを気にするものだ。	にも<br>とは<br>ほど<br>より
夫は横になる{{c1::なり}}いびきをかき始めた。	なり<br>かたがた<br>いなや<br>そばに
プロといえ{{c1::ども}}失敗することはある。	ども<br>でも<br>だに<br>ゆえ
彼は自分の意見を他人に強制する{{c1::きらいがある}}。	きらいがある<br>きらいである<br>きらいだ<br>きらいになる
ただ今{{c1::をもって}}、申し込みの受付を締め切ります。	をもって<br>にもまして<br>に際して<br>をおいて
たった１人で雪山登山なんて、危険{{c1::極まりない}}。	極まりない<br>に相違ない<br>の至り<br>にたえない
彼が行こうが{{c1::行くまいが}}、私は行くと決めている。	行くまいが<br>行かないが<br>行かなくても<br>わからないが
客{{c1::あっての}}商売だから、客は大切にしなければならない。	あっての<br>にあって<br>であれ<br>からある
親は、子供のことを考えれば{{c1::こそ}}厳しいことも言うのだ。	こそ<br>ため<br>すら<br>から
彼は以前から、外国で暮らしたいと言っていたから、退学の理由は想像に{{c1::かたくない}}。	かたくない<br>たえない<br>おかない<br>違いない
二十歳のときからたばこを吸っているが、今日を{{c1::限りに}}やめることにする。	限りに<br>皮切りに<br>末に<br>至って
彼は他人の非難をものともせずに、{{c1::自分のやり方を押し通す}}。	自分のやり方を押し通す<br>他人の意見を受け入れる<br>すぐに人に相談する<br>みんなから支持されている
財政問題は、ひとり東京のみならず、{{c1::日本全体の問題だ}}。	日本全体の問題だ<br>全員で解決策を考えるべきだ<br>みんなが知っている<br>国民の援助が必要だ
お気に{{c1::いたした}}のなら、さしあげます。	いたした<br>めした<br>あがった<br>なられた
この街に来たのは久しぶりなので、すっかり変わっていると思いきや{{c1::昔のままだった}}。	昔のままだった<br>まるで変わってた<br>昔のことは忘れてしまった<br>道に迷ってしまった
新製品に対する客の反応いかんでは、商品開発チームの{{c1::解散もありうる}}。	解散もありうる<br>努力があったからだ<br>腕次第だ<br>新製品は失敗だった
２０００年に年のコンピューターが狂う可能性があるという。そうなったら最後、{{c1::都市機能はまひしてしまう}}だろう。	都市機能はまひしてしまう<br>どの国で始まったこと<br>都市が破壊するしまつ<br>数年前から解決を急いでいる。
明るい性格のおいが東京の大学にいくので、我が家で暮らすことになった。{{c1::彼が来てからというもの}}家が明るくなった。	彼が来てからというもの<br>彼が来たのもさることながら<br>彼の性格をよそに<br>彼の明るさを限りに
母親は子供を助けるために、激しく燃える家に飛び込んでいった。これが愛でなくて{{c1::なんだろう}}。	なんだろう<br>母親というものだ<br>親の責任だ<br>感激の極みだ
彼女は機嫌が悪いと大声でどなりちらすことがある。時には、{{c1::聞くにたえない}}ようなひどいことを言うこともある。	聞くにたえない<br>聞きながらも<br>聞くべく<br>聞くごとき
家庭は子供が大部分の時間を過ごす場所である。{{c1::それゆえに}}、私は家庭でのしつけが一番重要だとかんがえるのです。	それゆえに<br>それなりに<br>それこそが<br>それにひきかえ
高速道路を爆破した犯人は、子供を交通事故で失った男だった。同情を{{c1::禁じえない}}が、かれのやったことは犯罪だ。	禁じえない<br>せんがためだ<br>余儀なくさせる<br>いかんだ
何の予告もなし{{c1::に}}面接試験をされてあわてた。	に<br>の<br>を<br>も
１０年間続いた「俳句の会」は次回{{c1::を}}限りに終了することになりました。	を<br>で<br>まで<br>が
こんなに頼んでも断られるなら、あきらめる{{c1::まで}}だ。	まで<br>から<br>こそ<br>より
あの子は大学に合格{{c1::して}}からというもの遊んでばかりいる。	して<br>した<br>する<br>しよう
台風で電車が止まっているから、出かけよう{{c1::にも}}出かけられない。	にも<br>でも<br>とも<br>かも
国際法を学ぶ{{c1::べく}}法学部に入学した。	べく<br>べからず<br>べし<br>べき
子供は海に{{c1::着く}}なり水遊びを始めた。	着く<br>着いた<br>着いて<br>着かない
こんな難しい問題に答えられる{{c1::とは}}彼はやはり優秀な学生だ。	とは<br>として<br>とも<br>とか
その結論に{{c1::至った}}お考えをお聞きしたい。	至った<br>関した<br>した<br>対した
彼は貧しさ{{c1::ゆえに}}十分な教育が受けられなかった。	ゆえに<br>なりに<br>ながらに<br>なしに
年老いた人をだますなんて、人にある{{c1::まじき}}行為だ。	まじき<br>ものを<br>まいし<br>なしに
試験の直前になって{{c1::あわてた}}ところで、どうにもならない。	あわてた<br>あわてて<br>あわてる<br>あわてよう
都心{{c1::とはいえ}}、このあたりはまだ緑が多く残っていて鳥の声も聞こえる。	とはいえ<br>とあって<br>ときたら<br>とあれば
近頃はめっきり歩かなくなって、近くのスーパーに{{c1::すら}}車で行ってしまう。	すら<br>だに<br>かぎり<br>こそ
彼はみんなの期待{{c1::をよそに}}就職もせずに遊び歩いている。	をよそに<br>ながらも<br>において<br>ところを
わざとじゃなかった{{c1::とはいえ}}けがをさせたのだから謝るべきだ。	とはいえ<br>とばかりに<br>として<br>とあって
どんな学生生活を送るかはじっくり{{c1::考える}}に足る問題だ。	考える<br>考えて<br>考えた<br>考えよう
お世話になったのだから、お礼の手紙を書かない{{c1::までも}}電話ぐらいはかけなさい。	までも<br>ものを<br>ところを<br>ならでは
彼の協力{{c1::なくして}}この事業は成功しなかっただろう。	なくして<br>にして<br>なりに<br>にあって
散歩{{c1::がてら}}近くのコンビニにアイスクリームを買いに行った。	がてら<br>ながら<br>かたわら<br>つつ
彼に{{c1::見られた}}が最後、二人の仲を隠し通すことは不可能だろう。	見られた<br>見られて<br>見られる<br>見られない
あなたの一生に{{c1::かかわる}}問題だから軽率には答えられない。	かかわる<br>応じる<br>たえる<br>比べる
日本経済の一日も早い回復を祈って{{c1::やまない}}。	やまない<br>たえない<br>かたくない<br>おかない
会社を発展{{c1::させん}}がため、社員一同努力を続けている。	させん<br>させて<br>させる<br>させよう
多くの困難を{{c1::ものともせず}}政治改革を進めた。	ものともせず<br>もとに<br>皮切りに<br>こめて
彼も心も入れ替えてやっとまじめに働く気になったと思いきや、{{c1::飲酒運転で事故を起こした}}。	飲酒運転で事故を起こした<br>まじめに働いている<br>働かずにはすまない<br>遊び歩かないものでもない
幼い子供といえども、罪を犯したからには罰を{{c1::与えずにはおかない}}。	与えずにはおかない<br>与えないきらいがある<br>与えるはずがない<br>与えるわけにはいかない
彼が音楽家として成功した影には、才能もさることながら、相当な努力が{{c1::あったにちがいない}}。	あったにちがいない<br>ないといったらない<br>あるはずがない<br>ありかねない
親にとっては、試験の結果にもまして、{{c1::子供の健康が何よりも心配だ}}。	子供の健康が何よりも心配だ<br>合格するまでだ<br>合格することが一番だ<br>子供の健康どころではない
大雨でいったん試合中止を宣言したが、天候の回復いかんによっては再開{{c1::しないわけではない}}。	しないわけではない<br>するはずがない<br>するまでもない<br>しないまでだ
彼は政治家として信頼{{c1::に}}足る人物だ。	に<br>を<br>が<br>で
上司の命令{{c1::と}}あれば、いやと言うわけにはいかない。	と<br>が<br>に<br>も
自然は一度破壊された{{c1::が}}最後、もう元の状態には戻らない。	が<br>を<br>に<br>と
労働{{c1::あって}}の余暇である。ただ休みが多ければいいというものではない。	あって<br>であって<br>とあって<br>にあって
互いの信頼関係{{c1::なくして}}何の友情だろうか。	なくして<br>をなくして<br>がなしに<br>をなしに
失敗を経験に{{c1::すれば}}こそ、よりたくましくなれるのだ。	すれば<br>したら<br>する<br>し
少し高いので、{{c1::買おうか}}、買うまいかと迷っている。	買おうか<br>買わないか<br>買おうではないか<br>買おうが
「食べ放題」というのは、食べたい{{c1::だけ}}食べていいということです。	だけ<br>かぎり<br>ほど<br>まで
前にも述べた{{c1::ごとく}}、私の決意は少しも変わっていない。	ごとく<br>きり<br>まま<br>なりに
楽しいこと{{c1::ずくめ}}だった正月休みも終わり、また仕事に戻らなければならない。	ずくめ<br>きり<br>ほど<br>くらい
時間がなかった{{c1::もので}}、準備が整わず申し訳ありません。	もので<br>からは<br>ことだから<br>ものなら
５年ぶりに会った甥は、見違える{{c1::ほど}}成長していた。	ほど<br>だけに<br>さえ<br>かのように
実力がありながら、上司の評価が低い{{c1::ばかりに}}出世できない社員もいないわけではない。	ばかりに<br>ように<br>ところで<br>ものの
私の作品が金賞をいただくとは、光栄の{{c1::いたり}}でございます。	いたり<br>かぎり<br>わたり<br>めぐり
この企画は委員会の決定{{c1::にそって}}作られた。	にそって<br>からして<br>にあって<br>について
細かい手作業に{{c1::かけては}}、本田君の右に出るものはいない。	かけては<br>たいして<br>向けて<br>つけては
若いうちは何にでも積極的に挑戦してみる{{c1::ことです}}。	ことです<br>ばかりです<br>はずです<br>ところです
うちの息子{{c1::ときたら}}、学校にも行かずにアルバイトばかりしている。	ときたら<br>としては<br>としたら<br>といっても
経験の浅い新人の{{c1::ことゆえ}}、不手際も多いかと思いますが、よろしくお願いいたします。	ことゆえ<br>だけに<br>ものを<br>ことから
政治家のスキャンダルは、{{c1::ひとり}}個人の問題のみならず、政治全体の問題である。	ひとり<br>ひとつ<br>ひとこと<br>ひとたび
卒業する学生諸君、君たちの今後の活躍を{{c1::願って}}やみません。	願って<br>願わざるを<br>願い<br>願わずに
王家の贅沢の{{c1::限り}}を尽くした宮殿はすばらしいといったらない。	限り<br>高み<br>深み<br>至り
営業成績を上げる{{c1::べく}}、社員全員ががんばっている。	べく<br>だに<br>なり<br>とは
国境周辺での衝突を{{c1::きっかけとして}}、両国の戦闘が開始された。	きっかけとして<br>ぬきにして<br>もとにして<br>はじめとして
失恋の痛みは身を{{c1::もって}}経験してはじめてわかるものだ。	もって<br>とって<br>かけて<br>つけては
「できない」と言ってしまえば{{c1::それまでだ}}が、とにかくやるだけやってみよう。	それまでだ<br>それだけだ<br>そのとおりだ<br>それよりほかない
この事件は解決まで{{c1::時間がかかると思いきや}}、犯人はすぐに逮捕された。	時間がかかると思いきや<br>時間がかかるまいと思いきや<br>時間はかからないまでも<br>時間がかかるにしても
一度客の信用を{{c1::失おうものなら}}、もう店の営業は成り立たなくなる。	失おうものなら<br>失えば失うほど<br>失うにしたがって<br>失うかぎり
彼女は「さあ帰れ」{{c1::と言わんばかりに}}玄関のドアを開けた。	と言わんばかりに<br>と言ったところで<br>と言ったばかりに<br>と言うまでもなく
定年まで勤め上げる{{c1::としたところで}}、老後の生活の保障があるわけてはない。	としたところで<br>につけても<br>にしては<br>にはかかわりなく
大金持ち{{c1::とはいえないまでも}}、十分豊かな生活ができるのだからいいじゃないか。	とはいえないまでも<br>かと思うと<br>はともかくとして<br>ではあるまいし
仕事をしているといっても、あいつの場合は机の前にすわっている{{c1::にすぎない}}。	にすぎない<br>きらいがある<br>までのことだ<br>にかたくない
ベストを尽くして悔いのない人生を{{c1::送りたいものだ}}。	送りたいものだ<br>送りたいものを<br>送らないものでもない<br>送れるものなら良い
大企業が相次いで倒産するという事実を知らされて、{{c1::驚きを禁じえない}}。	驚きを禁じえない<br>驚くまでもない<br>驚かないではおかない<br>驚くというものでもない
取材とはいえ、女一人で戦場に行くなんて、危険としか{{c1::いいようがない}}。	いいようがない<br>いえないこともない<br>いうまでもない<br>いったらない
もっとひどい例もあるのだから、これぐらいで驚く{{c1::にはあたらない}}。	にはあたらない<br>というものではない<br>どころではない<br>にほかならない
あれほど注意したにもかかわらず規則に違反したのだから、学校側は彼らを{{c1::処罰せずにはおかない}}。	処罰せずにはおかない<br>処罰されずにはおかない<br>処罰されないではいられない<br>処罰しないではいられない
犯人は、建物のかげに隠れているところ{{c1::を}}警官に見つかり、逮捕された。	を<br>に<br>へ<br>で
犬嫌いの息子は、犬の姿を見る{{c1::が}}早いか走り出す。	が<br>まで<br>と<br>や
いくらなんでも、そこまでいう{{c1::とは}}、ちょっと言い過ぎじゃないか。	とは<br>ので<br>のに<br>とも
両選手は、互いに追い{{c1::つ}}抜かれ{{c1::つ}}の激しいレースを展開した。	つ<br>つつ<br>なり<br>て
先日のお礼{{c1::かたがた}}、ちょっとご挨拶にうかがいたいと存じますが。	かたがた<br>ながら<br>かたわら<br>ともに
彼女のことだから、もうとっくに知っている{{c1::と思いきや}}、何も聞いていないそうだ。	と思いきや<br>にしては<br>にもかかわらず<br>と言わんばかりに
うちの主人と{{c1::きたら}}、朝寝坊のくせに、ゴルフに行く日だけは早場はと起きるんです。	きたら<br>しては<br>いえば<br>いっても
今朝、庭を掃除しているとき、どろ{{c1::まみれ}}の千円札を見つけた。	まみれ<br>だけ<br>ばかり<br>ずくめ
人の生命に{{c1::かかわる}}ような重大な問題を軽々しく扱うべきではない。	かかわる<br>たりる<br>こたえる<br>ともなう
何ぶん初めてのこと{{c1::とて}}、行き届かぬこともあろうかと思います。	とて<br>でも<br>さえ<br>なり
今さら失敗を悔やんだ{{c1::ところで}}、終わってしまったものは仕方がない。	ところで<br>ばかりに<br>もので<br>ことか
彼の{{c1::ごとき}}新入社員にそんな重大な任務を任せるわけにはいかない。	ごとき<br>ゆえの<br>といった<br>らしい
電車が動かないのなら、しかたがない。歩いて帰る{{c1::までだ}}。	までだ<br>ものだ<br>ばかりだ<br>はずだ
最近の若者は、ろくに努力もせずに楽をして金を稼ごうとする{{c1::きらい}}がある。	きらい<br>くせ<br>しだい<br>がち
さんざん考えた末、私{{c1::なりに}}作った企画がこれです。	なりに<br>ゆえに<br>ように<br>だけに
私が提案を読み上げると、社長はダメだ{{c1::とばかりに}}首を振った。	とばかりに<br>とあって<br>かと思うと<br>かのように
毎日こう忙しくては、{{c1::休もう}}にも休めない。	休もう<br>休む<br>休んで<br>休める
のんびり屋の兄だが、家族の一大事{{c1::ともなれば}}、けっこう頼りになる。	ともなれば<br>としたら<br>とすると<br>といえども
選手たちは、あらん{{c1::かぎり}}の力を出して決勝戦を戦った。	かぎり<br>ほど<br>くらい<br>だけ
あんなに器用な彼に{{c1::して}}作れなかった物だ。僕なんかに作れっこない。	して<br>こそ<br>しろ<br>とって
Ｍ社の新型パソコンは、操作のしやすさもさることながら、{{c1::価格の安さが大きな魅力である}}。	価格の安さが大きな魅力である<br>だれでも楽に使うことができる<br>初心者に好評だ<br>前の機種よりはるかに改良されている
一人でそんなに苦労していたとは知らなかった。一言いってくれれば{{c1::何か手助けができたものを}}。	何か手助けができたものを<br>君を助けてあげたいものだ<br>なんとか助けてあげたかった<br>君の役に立てるだろう
何をするにしても、基礎からしっかり勉強しないことには、{{c1::上達は望めない}}。	上達は望めない<br>上達しないまでのことだ<br>上達するべきではない<br>上達せずにはいられない
どの問題も我々の力の及ぶところではなかった。今度の問題にしたって{{c1::解決などできはしないだろう}}。	解決などできはしないだろう<br>解決しないわけにはいかない<br>解決できないことはない<br>解決できないものでもない
私が明日社長のところにうかがって、報告書を{{c1::お渡しできると存じます}}。	お渡しできると存じます<br>お渡しされると存じております<br>お渡しされると存じます<br>お渡しできると存じます
その女のあまりのあつかましさ{{c1::に}}、私はあきれてしまった。	に<br>で<br>から<br>を
大阪は東京{{c1::に}}ついで人口が多い。	に<br>から<br>を<br>が
給料の２割増{{c1::を}}条件に、その仕事を引き受けることにした。	を<br>まで<br>の<br>が
１週間にわたる試験もいよいよ明日{{c1::で}}終わる。	で<br>が<br>に<br>まで
これだけの機能をそろえたパソコンだと、定価で５０万{{c1::から}}する。	から<br>より<br>だけ<br>まで
犬は主人の姿を{{c1::見る}}が早いか、元気よく走り寄った。	見る<br>見た<br>見て<br>見よう
競技場に着いたとき、試合はすでに{{c1::始まっていた}}。	始まっていた<br>始まった<br>始まりかけた<br>始まったばかりだった
一時停止をせずに交差点に入り、あやうく衝突する{{c1::ところだった}}。	ところだった<br>はかりだった<br>そうになった<br>ことになった
アメリカ人と話しているとき、自分の英語が{{c1::下手なのではないか}}と不安になることがある。	下手なのではないか<br>下手ではない<br>上手なのではないか<br>上手ではないか
彼女はさも私がバカだと{{c1::言わんばかり}}の顔でこっちを見た。	言わんばかり<br>言うらしい<br>言いたげ<br>言いたそう
子供が元気で{{c1::さえあれば}}、親は安心していられるものだ。	さえあれば<br>さえすれば<br>こそあれば<br>こぞすれば
シャツのボタンが{{c1::とれている}}から、糸と針を持ってきて。	とれている<br>とられてある<br>とっている<br>とられる
そのピアニストは16歳{{c1::にして}}コンクールに優勝した。	にして<br>をもって<br>をして<br>にとって
震災後の神戸の街は、見るに{{c1::たえない}}状態であった。	たえない<br>すぎない<br>かたい<br>ほかならない
長年の研究が実り受賞できたことは、{{c1::感激の}}至りです。	感激の<br>幸せな<br>うれしい<br>喜ぶ
結婚した息子は、手紙は{{c1::おろか}}、電話さえかけてこない。	おろか<br>ひきかえ<br>かまわず<br>とにかく
その議員は言う{{c1::べからざる}}言葉を吐いて、世間を騒がせた。	べからざる<br>べく<br>べきがない<br>べからず
この大雨では、問い合わせる{{c1::までもなく}}スポーツ大会は中止だろう。	までもなく<br>ものではなく<br>はかなく<br>わけなく
人間にとって、生活の維持も{{c1::さることながら}}、よりよく生きることが大切な問題だ。	さることながら<br>かまわず<br>かかわらず<br>ものともせずに
クレジットカードの使いすぎで、破産しない{{c1::までも}}借金の返済に苦しむ人が増えている。	までも<br>かぎり<br>ところで<br>とすると
両親とも芸術家{{c1::とあって}}、彼女のセンスのよさは抜群だ。	とあって<br>からして<br>とあいまって<br>からすると
新空港の建設候補地は、交通の便のよさという点で当地{{c1::をおいて}}ほかにはないだろう。	をおいて<br>を問わず<br>と言わず<br>をもって
収入の多少を{{c1::問わず}}税額が一律であるとは、どうも納得できない。	問わず<br>かかわらず<br>よそに<br>通じて
我々はとかく西洋医学を信じすぎる{{c1::きらい}}がある。	きらい<br>がち<br>つもり<br>しまつ
結婚{{c1::しようが}}しまいが自由だが、子供に対する責任だけはきちんと果たすべきだ。	しようが<br>しても<br>するか<br>しようにも
いつも遅刻する彼女のことだから、{{c1::今日もまた遅刻だろう}}。	今日もまた遅刻だろう<br>遅刻せずにはいられない<br>また遅刻をした<br>遅刻ばかりしている
両国間の和平交渉はおそらく{{c1::うまくいかないだろう}}。	うまくいかないだろう<br>うまくいきそうだ<br>うまくいかないようだ<br>うまくいくかもしれない
どんなに働いてもアルバイト収入は{{c1::10万円がせいぜいだ}}。	10万円がせいぜいだ<br>10万円せいぜいだ<br>せいぜいで10万円だ<br>せいぜいが10万円だ
超大国と呼ばれる国があれほど簡単に崩壊するとは、{{c1::夢にも思わなかった}}。	夢にも思わなかった<br>なかなか思えなかった<br>予想できたかもしれない<br>考えないでも
ほしいと言えばあげたものを、{{c1::どうして言わなかったの}}。	どうして言わなかったの<br>返すなんて失礼ですよ<br>予想できたかもしれない<br>考えないでもなかたった
雨の少なかった昨年にひきかえ、{{c1::今年は雨が多い}}。	今年は雨が多い<br>今年は雨が少ない<br>水不足が解消した<br>水不足が深刻だった
できないと{{c1::言ってしまえばそれまでだが}}、せっかくのチャンスだ。やれるところまでやってみよう。	言ってしまえばそれまでだが<br>言うまでもないが<br>言わないにしても<br>言ってしまうのは簡単だから
今の職場や仕事に満足している人は{{c1::３割前後}}といったところだろう。	３割前後<br>それほど多くはない<br>ほとんどいない<br>かなり減っている
難しい、難しいと{{c1::言いながらも}}、その学生は試験でけっこういい点を取っている。	言いながらも<br>言うにつけ<br>言うにつれて<br>言ったところで
彼女は、{{c1::一度言い出したが最後}}決して意志を曲げることのない人だ。	一度言い出したが最後<br>一度言い出すや否や<br>一度言い出したとしても<br>一度言い出すなり
その子はたいへん賢く、{{c1::教えるそばから}}覚えてしまう。	教えるそばから<br>教えるかたわら<br>教えている最中に<br>教わりつつも
やせたいんですね。それじゃ、{{c1::食べたいだけ食べる}}というわけにはいかないでしょう。	食べたいだけ食べる<br>太らないように食べる<br>太らないだけ食べる<br>食べたいくらい食べる
ゴールデンウイーク{{c1::と}}あって、観光地はどこも大変な人手だ。	と<br>に<br>で<br>は
市民の批判{{c1::を}}よそに、今日も社長は会議中にいねむりをしていた。	を<br>が<br>ひ<br>の
この間の試験はひどく悪かった。苦手の数学に至って{{c1::は}}クラスの最下位だった。	は<br>も<br>まで<br>までも
成功おめでとう。この企画は、君の力{{c1::なしには}}できなかっただろう。	なしには<br>ないでは<br>ならでは<br>ないまで
この事件の裏に大物政治家が存在することは、想像に{{c1::かたくない}}。	かたくない<br>かたい<br>かたからず<br>かたかろう
中小企業への政府の補助は、個々の企業の実情に{{c1::即して}}行われるべきだ。	即して<br>関して<br>基にして<br>限って
公園は、東京を{{c1::皮切りに}}、名古屋、大阪と日本各地を回る予定だ。	皮切りに<br>はじめに<br>限りに<br>きっかけに
人の顔を{{c1::見る}}なり笑い出すなんて、失礼なやつだ。	見る<br>見た<br>見ない<br>見て
研究者{{c1::たる}}者、真実を追究する心を失ってはならぬ。	たる<br>まじき<br>ごとき<br>ある
出土した黄金の装飾品は、贅沢の{{c1::極み}}を尽くした当時の王族の生活を想像させる。	極み<br>至り<br>至る<br>極まる
ずいぶん春{{c1::めいて}}まいりました。お変わりなくお過ごしでしょうか。	めいて<br>まみれて<br>らしく<br>ともなって
こんなことになるとは、想像{{c1::だに}}しなかった。	だに<br>まで<br>とは<br>ばかり
娘は勉強もせずに遊んでばかりいたが、ついに高校をやめて歌手になりたいと言い出す{{c1::しまつ}}で、私も妻も困り切っている。	しまつ<br>あげく<br>結果<br>最後
釣り自慢の父は体長が１メートル{{c1::からある}}魚を釣って、大得意である。	からある<br>のごとき<br>ならではの<br>ましの
兄は、大学で医学を勉強する{{c1::かたわら}}、小説を書いている。	かたわら<br>がてら<br>が早いか<br>かたがた
「おいおい、電気が{{c1::つけっぱなしだ}}よ。」「あっ、いけない。消しといて」	つけっぱなしだ<br>つけっぽい<br>つけかけだ<br>つけっきりだ
この島には、電話{{c1::はおろか}}、水道も電気もない。	はおろか<br>が最後<br>までも<br>ですら
あの二人はよほど仲が悪いのだろう。いつも{{c1::聞くにたえない}}言葉で言い争っている。	聞くにたえない<br>聞きづらい<br>聞きかねない<br>聞きにくい
そんなにひどくなるまで我慢するなんて。言ってくれれば病院へ連れていってあげた{{c1::ものを}}。	ものを<br>ものだ<br>わけだ<br>ほどだ
オリンピックで{{c1::優勝せん}}がために、選手達は血のにじむような練習を続けている。	優勝せん<br>優勝した<br>優勝しよう<br>優勝せぬ
「現在の法律では被害者の人権が守られていない」と彼女は涙{{c1::ながらに}}訴えた。	ながらに<br>ばかりに<br>だけに<br>がちに
そんなことはわかりきっている。今さら{{c1::言うまでもない}}。	言うまでもない<br>言うまでだ<br>言うまでのことだ<br>言わないまでだ
子供の暴力事件は常に存在していたが、最近は以前{{c1::にもまして}}暴力が激化しているようだ。	にもまして<br>に至って<br>に対して<br>にも及んで
かたづけた{{c1::そばから}}子供がちらかすので、部屋がきれいにならない。	そばから<br>あとから<br>わきから<br>のちから
計画は完璧だ。あとは、{{c1::ただ}}実行するのみ。	ただ<br>なお<br>さて<br>ただし
貴重な水だ。１滴{{c1::たりとも}}無駄にしてはいけない。	たりとも<br>ともなく<br>を限りに<br>をもって
彼女は重圧を{{c1::ものともせず}}、のびのびとした演技で見事に１位を獲得した。	ものともせず<br>こともなく<br>わけにはせずに<br>ないとはいえ
本日は、６時{{c1::をもって}}閉店とさせていただきます。またのご来店をお待ち申し上げます。	をもって<br>にあって<br>にして<br>を限りに
子供は{{c1::子供なりに}}、人間関係でストレスを感じている。	子供なりに<br>大人もさることながら<br>子供ならでは<br>大人なりに
佐藤君は、{{c1::能力といい、人柄といい}}、この仕事にふさわしい人物だ。	能力といい、人柄といい<br>能力やら、人柄やら<br>能力とか、人柄とか<br>能力なり、人柄なり
この仕事を頼めるのは、君をおいて{{c1::ほかにいない}}。	ほかにいない<br>だれでもいい<br>だれでもない<br>ほかならない
あんな弱いチームに負けるなんて、{{c1::くやしいったらない}}。	くやしいったらない<br>くやしいきらいがある<br>くやしいにたえない<br>くやしくてやまない
歌は決して得意ではないが、「是非に」と言われれば{{c1::歌わないものでもない}}。	歌わないものでもない<br>歌うにはあたらない<br>歌うべくもない<br>歌わないまでだ
若い女性が積極的なのにひきかえ、{{c1::男性は消極的になりがちだ}}。	男性は消極的になりがちだ<br>男性の方が積極的だ<br>男性も積極的だ<br>男性は消極的にならざるを得ない
資源を大切にと言いながらも、紙の使用量は{{c1::一向に減らない}}。	一向に減らない<br>減らさざるを得ない<br>減る一方だ<br>減らすとも限らない
10メートル{{c1::からある}}大木が私たちのいる方向へ倒れてきた。	からある<br>からする<br>からみる<br>からいう
いくら制度が変わっても現状は何{{c1::ら}}変わらない。	ら<br>に<br>と<br>を
チンさんは、とくに{{c1::これ}}といった特徴のない人だ。	これ<br>それ<br>あれ<br>どれ
林さんは何かに{{c1::つけ}}口を出してくるので、みんなにさけられている。	つけ<br>ついて<br>つれて<br>つつ
受賞まであと一歩のところまでいったのだが、だめだった。　残念で{{c1::ならない}}。	ならない<br>なる<br>すぐない<br>すぎる
考えてみた{{c1::ところ}}で、やってしまったことは変えられないのだ。	ところ<br>ばかり<br>あげく<br>ついで
チャイムが鳴ったか{{c1::鳴らない}}かのうちに、学生たちが机の上をかたづけはじめた。	鳴らない<br>鳴る<br>鳴った<br>鳴らなかった
いつも５分か１０分おくれてくる山下さんの{{c1::こと}}だから、今日もおくれるにちがいない。	こと<br>はず<br>もの<br>せい
教師{{c1::たる}}ものは、すべての学生に平等に接するべきだ。	たる<br>こそ<br>まで<br>めく
お母さんがせんたくを{{c1::する}}かたわらで、子どもたちが水遊びをしている。	する<br>して<br>した<br>し
最近とても運がよく、いいこと{{c1::ずくめ}}の毎日だ。	ずくめ<br>がてら<br>かぎり<br>はじめ
お金{{c1::さえあれば}}幸せになれるとはかぎらない。	さえあれば<br>こそあれば<br>さえすれば<br>こそすれば
近所の子どもは、2歳{{c1::にして}}すでに簡単な計算ができる。	にして<br>をして<br>でして<br>がして
「時は金なり」とは、時間を１分{{c1::たりとも}}むだに使うなということだ。	たりとも<br>こととて<br>そばから<br>ならでは
私は今、責任者と言う立場{{c1::にあって}}、すべてのことに気を配らなければならない。	にあって<br>にしいて<br>につけて<br>にしたがって
島田さんは「おまえが悪い」と{{c1::言わんばかり}}の態度で私をにらみつけた。	言わんばかり<br>言いたげ<br>言うらしい<br>言わんくせ
家の前で{{c1::行き・戻り}}つ{{c1::行き・戻り}}つして、うろうろしている男の人はいったいだれなのだろう。	行き・戻り<br>行く・戻る<br>行くか・戻るか<br>行って・戻って
両親{{c1::あって}}の私である。人間は一人で生きられるものではない。	あって<br>とあって<br>であって<br>にあって
うそをついたのなら、{{c1::あやまらず}}にはすまないだろう。	あやまらず<br>あやまる<br>あやまった<br>あやまらない
彼は{{c1::もとより}}おとなしく、文学を好む少年であった。	もとより<br>もはや<br>ものの<br>のもなら
自分が不利だとみるや、あいつと{{c1::きたら}}ころっと態度を変えた。	きたら<br>いえども<br>思いきや<br>相まって
電車の中で隣に座った人たちの会話を聞く{{c1::ともなく}}聞いていたら、知り合いの名前が出てきて驚いた。	ともなく<br>ともなれば<br>とはいえ<br>ときたら
親友と{{c1::いえども}}、言っていいことと悪いことがある。	いえども<br>いうと<br>いったら<br>いいつつ
私の父はよく散歩し{{c1::がてら}}、スーパーに寄り、家族の好きなものを買ってきてくれる。	がてら<br>かたがた<br>そばから<br>ともに
少しずつ春{{c1::めいて}}きましたが、いかがお過ごしでしょうか。	めいて<br>らしく<br>まみれて<br>ごとく
彼は日本に来て５年になるのに、漢字はおろか{{c1::ひらがなさえも書けない}}。	ひらがなさえも書けない<br>ひらがなだけは書ける<br>難しい言葉も理解している<br>やさしいことばも理解している
あの大地震で家族を亡くした方や、家を失った方には{{c1::同上を禁じえない}}。	同上を禁じえない<br>同情するまでもない<br>同情するにたらない<br>同情するにたえない
大事故にいたらなくてよかったものの、一つ間違えば{{c1::けがどころではすまなかった}}。	けがどころではすまなかった<br>何事もなく無事であった<br>死ぬおそれはなかった<br>死ぬどころではなかった
松下さんは{{c1::一度言い出したが最後}}、決して考えを曲げない。	一度言い出したが最後<br>一度言い出すや否や<br>一度言い出すなり<br>一度言い出すや否や
大変お待たせいたしました。ただいまより、すばらしい手品を{{c1::ごらんにいれましょう}}。	ごらんにいれましょう<br>ごらんいたしましょう<br>ごらんになりましょう<br>ごらんくださいましょう
授業は欠席がちで、課題も提出しないとは、{{c1::学生にあるまじき}}行動ではないか。	学生にあるまじき<br>学生にないまじき<br>学生といえるまじき<br>学生と言えないまじき
アルク党の党首に対する批判が高まっているが、{{c1::そのような批判をものともせず}}当の本人は次々と新しい政策を打ち出している。	そのような批判をものともせず<br>そのような批判を余儀なくし<br>そのような評判をかわ切りにして<br>そのような批判を禁じ得ず
行かないと{{c1::言ってしまえばそれまでだが}}、後々後悔することになるかもしれないよ。	言ってしまえばそれまでだが<br>言わないとしても<br>言うまでもないが<br>言ってしまうのは簡単だから
昨晩のパーティーは、さすが{{c1::山本さんならではの}}すばらしい演出でしたね。	山本さんならではの<br>山本さんとしては<br>山本さんだとしても<br>山本さんとしたことが
その件につきましては、先日、担当の木下が{{c1::うけたまわっておりますので}}、ご安心ください。	うけたまわっておりますので<br>お目にかかりますので<br>存じておりますので<br>ご覧くださいましたので
この病気は手術を{{c1::しない}}限り、治りません。できるだけ早く手術を受けてください。	しない<br>しなくて<br>して<br>する
年を取ってからの勉強は効率が悪い。聞いた{{c1::そばから}}忘れていくのだから。	そばから<br>や否や<br>あいだに<br>うちに
空の青さと紅葉のあざやかさとが{{c1::あいまって}}、秋の高原は絵のように美しい。	あいまって<br>あい変わらず<br>ともなって<br>集まって
市価より２，３割安い{{c1::とあって}}、商品はあっという間に売り切れてしまった。	とあって<br>からして<br>といえども<br>からといって
ごくわずか{{c1::ながら}}、景気回復の兆しが見え始めた。	ながら<br>にしては<br>にひきかえ<br>ながらに
低温に{{c1::たえる}}野菜の品種改良が待たれている。	たえる<br>たる<br>あたる<br>かかわる
息子はほとんど家にいない。帰ってきた{{c1::かと思うと}}、またすぐ出かけてしまう。	かと思うと<br>ばかりに<br>やいなや<br>なり
この報道は必ずしも真実を伝えているもの{{c1::とは思えない}}。	とは思えない<br>にちがいない<br>であろう<br>にあたらない
国民の信頼{{c1::にたる}}政治家がなんと少ないことか。	にたる<br>にあたる<br>にいたる<br>におよぶ
電車が動かないなら、歩いて帰る{{c1::しかない}}。	しかない<br>ほどだ<br>わけだ<br>くらいだ
よくよく{{c1::考えた}}うえで決めたことだから、たとえ失敗してもいいじゃないか。	考えた<br>考える<br>考えて<br>考え
社長の命令{{c1::とあれば}}、長期の出張も引き受けざるをえない。	とあれば<br>にせよ<br>にしては<br>としても
失恋の悲しみは身をもって経験して{{c1::はじめて}}わかるものだ。	はじめて<br>とうとう<br>いよいよ<br>いまだに
こんなことを言えば彼女を傷つけることになると知り{{c1::つつも}}、言わざるをえなかった。	つつも<br>かねて<br>かけて<br>すぎて
政治家が次々に逮捕されるという事態に国民は失望を{{c1::禁じ得ない}}。	禁じ得ない<br>かたくない<br>ほかならない<br>極まりない
勉強が好きではない{{c1::にしても}}、高校はちゃんと卒業しておいたほうがいい。	にしても<br>ながら<br>といって<br>として
生物はより優れた子孫を{{c1::残さんがために}}、激しい生存競争を展開する。	残さんがために<br>残すまいと<br>残さんばかりに<br>残しかねて
私の後ろの男は、早く行け{{c1::とばかりに}}私の背中を押した。私は危うく倒れるところだった。	とばかりに<br>といっても<br>といわず<br>としても
一見すると古くて汚いが、これらの道具の中には一つ{{c1::たりとも}}余分なものはない。	たりとも<br>に限って<br>なりに<br>にひきかえ
ボランティア活動は経験の有無{{c1::を問わず}}、だれでも参加できる。	を問わず<br>をもって<br>と言わず<br>をおいて
対応がもっと早ければ被害は少なくて済んだ{{c1::ものの}}、救助が遅れて被害が広がった。	ものの<br>もので<br>ものか<br>ものを
教養ある紳士{{c1::といえども}}、時には礼儀を欠くこともある。	といえども<br>ときたら<br>ともなると<br>とすれば
われわれは世界平和の実現を{{c1::願って}}やまない。	願って<br>願い<br>願って<br>願う
あの人ったら自分が悪いくせに、いつも{{c1::ひとのせいにする}}。	ひとのせいにする<br>あやまってばかりいる<br>結局困っている<br>失敗ばかりしている
海外旅行へ出発する日にパスポートを忘れるとは、{{c1::なんというバカだろう}}。	なんというバカだろう<br>よく注意をした<br>十分気をつけよう<br>困ってしまった
一人暮らしは、楽しいとは言えないまでも、{{c1::気楽でいい}}。	気楽でいい<br>不自由なこともある<br>やはり、家族と一緒がいい<br>やはり、さびしいものだ
事故にあい、命を落とさずにすんだものの、{{c1::右足が不自由になってしまった}}。	右足が不自由になってしまった<br>生きていてよかった<br>幸運だったと思う<br>今後は安全運転を心掛けよう
彼女の責任が問われているほうだが、私の知る限りでは{{c1::彼女には何の責任もない}}。	彼女には何の責任もない<br>何も話すことはない<br>事実を全部話そう<br>これ以上は何もわからない
国民の期待というプレッシャーの大きさは{{c1::想像にかたくない}}が、彼女はそれを見事に克服して、金メダルを獲得した。	想像にかたくない<br>想像できない<br>想像できることはできる<br>想像することはない
現状に即した対策を{{c1::立てるべきところを}}、理論だけが空回りしている。これでは事態を打開することは難しいだろう。	立てるべきところを<br>立てるべきだから<br>立てたところで<br>立てただけあって
被災地の受験生も、人生の分かれ道ともいえる入学試験に{{c1::合格するべく}}、厳しい条件の下で準備に励んでいる。	合格するべく<br>合格したいのだが<br>合格したいものの<br>合格しようにもできず
当社では新入社員の採用に当たり、応募者の{{c1::学業成績のみならず}}、趣味、特技等も考慮して選考を行っている。	学業成績のみならず<br>学業成績をものともせずに<br>学業成績はおろか<br>学業成績にひきかえ
その行動力といい、指導力といい、彼こそトップにふさわしい人だ。次期会長は{{c1::彼をおいてほかにいない}}、というのが大方の見方である。	彼をおいてほかにいない<br>彼にあるまじきことだ<br>ひとり彼だけではない<br>彼でなくてもいい
私の知る{{c1::限りでは}}、彼と彼女の仲はうまくいっているようだ。	限りでは<br>限って<br>限りに<br>限らず
あの男{{c1::ほど}}善良な人間を、私は知らない。	ほど<br>ばかり<br>なんて<br>つつ
今日は天気がいいから、散歩{{c1::がてら}}一人暮らしの祖母の様子を見てこよう。	がてら<br>ながら<br>かたわら<br>つつ
住民の不安を{{c1::よそに}}、原子力発電所の建設計画が進められている。	よそに<br>あとに<br>ほかに<br>そとに
厳しい訓練に耐えてきた兵士たちは、身動き{{c1::たに}}せず、門の前に立っていた。	たに<br>こそ<br>だけ<br>にも
年をとって怒りっぽくなった父は、最近では近所の子供にまで大声でどなる{{c1::しまつ}}だ。	しまつ<br>こと<br>はず<br>わけ
高い評価を得ている彼女だが、最近の演奏は以前にも{{c1::まして}}すばらしい。	まして<br>及んで<br>加えて<br>くらべて
子供の将来を{{c1::思えば}}こそ、親は心を鬼にしなければならないこともある。	思えば<br>思うと<br>思ったら<br>思うなら
マイホームを手に入れようと決心した兄は、昼も夜も汗{{c1::まみれ}}になって働いた。	まみれ<br>ばかり<br>たっぷり<br>ずくめ
三つや四つの子供では{{c1::あるまいし}}、いつまでも人に頼っていてはだめだ。	あるまいし<br>ないだろうと<br>なくても<br>ありそうもなく
過去の失敗を今さら{{c1::悔やんだ}}ところで、どうにもならない。	悔やんだ<br>悔やみ<br>悔やんで<br>悔やむ
一緒に入社した彼が昇進したのに{{c1::ひきかえ}}、私はいまだに平社員のままだ。	ひきかえ<br>かえって<br>かかららず<br>かわって
今回の事件も{{c1::さることながら}}、最近、犯罪の犠牲となって命を失う人があとを絶たない。	さることながら<br>のみならず<br>かまわず<br>もっともだが
ひと雨ごとに春{{c1::めいて}}、何となくうきうきした気分になる。	めいて<br>のように<br>づいて<br>っぽく
人間六十歳{{c1::ともなると}}、多かれ少なかれ、先のことを考えるものだ。	ともなると<br>からすると<br>からして<br>となってみたら
わが社は今回の台湾進出を{{c1::かわきりに}}、今後海外に進出していく予定である。	かわきりに<br>中心に<br>はじめに<br>先頭に
大学進学を決めた{{c1::以上}}、合格するべく頑張らなければならない。	以上<br>もので<br>ことから<br>次第
社長は、二十歳{{c1::にして}}すでに今の会社の基礎を築いていたそうだ。	にして<br>になって<br>において<br>にとって
今月末を{{c1::もって}}、父は４０年あまり勤めた会社を定年退職する。	もって<br>になって<br>よって<br>とって
よほど疲れていたのだろう。彼女は横になる{{c1::なり}}、寝入ってしまった。	なり<br>まま<br>否か<br>きり
いくら息子のためとはいえ、大金をつかって入学させるなど、愚か{{c1::としか言いようがない}}。	としか言いようがない<br>とだけ言える<br>とのみ言うべきだ<br>とでも言うべきだ
彼女の乱暴なものの言い方は、聞くに{{c1::たえない}}。	たえない<br>かたい<br>たりない<br>はずかしい
不正に公金を利用した部長は、退職を{{c1::余儀なくされた}}。	余儀なくされた<br>しないわけではない<br>禁じざるを得ない<br>迫っていた
どうしても、というのであれば、{{c1::やらないものでもない}}。	やらないものでもない<br>やらないことにすぎない<br>やらないはずだ<br>やらなくなるべきだ
息子の突然の死を嘆く母親を前に、私は言葉もなく、ただ見守る{{c1::はかはなかった}}。	はかはなかった<br>のみではなかった<br>ほかでもなかった<br>にすぎなかった
当店の営業は、６時{{c1::を}}もって終了とさせていただきます。	を<br>に<br>から<br>と
彼なり{{c1::と}}よく考えて出した結論ならばそうするより仕方がないだろう。	と<br>で<br>に<br>も
離婚の原因は彼にあるが、彼女{{c1::に}}したって、ある程度は後悔していると思うよ。	に<br>から<br>を<br>が
いくら優勝したいからといって、体を壊すまで練習しなくてもいいもの{{c1::を}}。	を<br>から<br>だ<br>で
残り時間あと２分。もう絶対に負けたと{{c1::思いきや}}、最後の最後で逆転した。	思いきや<br>思おうにも<br>思ったにせよ<br>思わずには
人前でスピーチするのは初めてのこと{{c1::とて}}、彼はすっかり緊張していた。	とて<br>であっても<br>だのに<br>といって
心理学者と{{c1::いえども}}、娘の心理が理解できないこともある。	いえども<br>いったら<br>いうと<br>いえば
まったく、この子と{{c1::きたら}}親の言うことをちっとも聞かない。	きたら<br>すれば<br>したら<br>いえば
失敗してから後悔した{{c1::ところで}}、今さらどうしようもない。	ところで<br>だけで<br>もので<br>はずで
経費削減のため、紙一枚{{c1::たりとも}}無駄にしないこと。	たりとも<br>のみの<br>だけしか<br>くらいの
社員{{c1::あって}}の会社であるはずが、この会社は社員の待遇を一向に改善しようとしない。	あって<br>にとって<br>として<br>をおいて
毎日汗{{c1::まみれ}}になって働いても、生活は一向に楽にならない。	まみれ<br>だけ<br>くらい<br>ばかり
前の席の二人の会話を聞く{{c1::ともなしに}}聞いていたら、姉の名前が出てきて驚いた。	ともなしに<br>ために<br>ことなしに<br>ように
「お前{{c1::ごとき}}におれの気持ちなどわかるものか！」と彼はどなった。	ごとき<br>だけ<br>のよう<br>みたい
昇進できるかどうかは、今年の営業成績{{c1::いかん}}だ。	いかん<br>ばかり<br>から<br>かぎり
財布を忘れ、買い物を{{c1::しよう}}にもできなかった。	しよう<br>できる<br>する<br>できない
人の失敗を笑い話にするとは、失礼{{c1::きわまる}}やつだ。	きわまる<br>いたる<br>かぎる<br>かねる
いつも慎重な彼に{{c1::しては}}めずらしく、思い切ったことをしたものだ。	しては<br>しても<br>かぎって<br>かえって
あの程度の雨量で大洪水が起こるとは、だれも予想{{c1::だに}}しなかった。	だに<br>こそ<br>しか<br>のみ
友達とけんかでもしたらしく、娘は帰ってくる{{c1::なり}}泣き出した。	なり<br>から<br>あと<br>まで
彼女は商社に勤める{{c1::かたわら}}、週末は近所の子供たちに英語を教えている。	かたわら<br>他方<br>そばで<br>反面
言葉には表されない{{c1::までも}}、不賛成の意向は彼の態度から十分読める。	までも<br>ようで<br>としても<br>ために
彼の無礼な行為は、若さ{{c1::ゆえ}}の過ちとして片づけられるものではない。	ゆえ<br>より<br>のみ<br>だけ
高速道路の騒音対策は、地域の実情に{{c1::即して}}行われるべきである。	即して<br>対して<br>次いで<br>臨んで
さあ、どうぞ。何でも好きな物を食べたい{{c1::だけ}}食べてください。	だけ<br>くらい<br>ほど<br>ばかり
さすが彼のような有名人ともなると、{{c1::気軽に町を歩くこともできない}}。	気軽に町を歩くこともできない<br>気軽に町を歩かざるをえない<br>気軽に町を歩かずにはいられない<br>気軽に町を歩く嫌いがある
能力といい、人格といい、あの人をおいて、{{c1::トップにふさわしい人はいない}}。	トップにふさわしい人はいない<br>トップになるべきではない<br>とっぷになるべきだ<br>トップにふさわしい人だ
人の一番大切な物を壊しておいて、{{c1::「ごめんなさい」だけでは済まないよ}}。	「ごめんなさい」だけでは済まないよ<br>「ごめんなさい」と言えばいいのに<br>「ごめんなさい」と言うべきだ<br>「ごめんなさい」と言うはずだ
「世の中、金がすべて」とはいっても、愛情なくしては{{c1::とても生きていけない}}。	とても生きていけない<br>生活することも不可能ではない<br>十分生活できるだろう<br>生きられないこともない
ベルがなるや否や、生徒たちは{{c1::一斉に教室を飛び出した}}。	一斉に教室を飛び出した<br>一人また一人と帰っていった<br>熱心に勉強している<br>勉強から解放されている
子供の将来を{{c1::心配すればこそ}}、親は厳しいことを言うものなのです。	心配すればこそ<br>心配するからには<br>心配しながらも<br>心配したところで
今年度の試験は、{{c1::昨年度にもまして}}難しくなっている。	昨年度にもまして<br>昨年度について<br>昨年度からして<br>昨年度に対して
彼女の成功は{{c1::家族の協力をぬきにしては}}、語れない。	家族の協力をぬきにしては<br>家族の協力があってこそ<br>自身の努力がなければ<br>自身の努力があればこそ
金があるからといって、{{c1::子供にむやみに物を与えると}}、子供はろくな大人にはならない。	子供にむやみに物を与えると<br>子供を厳しく育てると<br>子供に節約を強いるなら<br>子供を質素に育てると
環境問題は、{{c1::ただ一国のみならず}}、各国が協力して取り組むべきである。	ただ一国のみならず<br>一国だけにかかわらず<br>一国が行うまでもなく<br>ただ一国だけであれ
工事中{{c1::につき}}、お足もとに十分ご注意ください。	につき<br>だけあって<br>ことから<br>とあって
会社に入った{{c1::からには}}、全力で仕事をするつもりです。	からには<br>ばかり<br>からして<br>ところ
これを{{c1::もって}}、今日のパーティーは閉会といたします。ありがとうございました。	もって<br>もとに<br>めぐって<br>かぎりに
こんなに雨が少ないと、水不足になり{{c1::かねない}}。	かねない<br>がたい<br>かもしれない<br>つつある
外国に住む{{c1::としたら}}、たとえばどこに行きたいですか。	としたら<br>とあれば<br>といっても<br>とはいえ
たとえ学歴が低くても、努力{{c1::しだいで}}出世することもできる。	しだいで<br>ながら<br>において<br>にあって
銀座の一流店というと、「高い」と思われ{{c1::がち}}だが、必ずしもそうではない。	がち<br>しだい<br>もの<br>気味
両親が音楽家という{{c1::だけあって}}、その子も早くから音楽の才能を示した。	だけあって<br>もので<br>ことから<br>からいって
当時ひどく貧乏だった私は、バイクは{{c1::おろか}}、自転車も買えなかった。	おろか<br>とにかく<br>ないまでも<br>どころか
子供でさえすぐ理解できるようなことがわからないとは、情けない{{c1::かぎり}}。	かぎり<br>きり<br>いっぽう<br>します
子供は母親の姿を見る{{c1::やいなや}}、走りだした。	やいなや<br>とたん<br>そばから<br>ところを
いつも朗らかな彼女{{c1::にして}}あれほど沈んでいたのだから、相当なショックだったにちがいない。	にして<br>らしく<br>なりに<br>ゆえ
ライオンは獲物をねらった{{c1::が最後}}、決して逃さない。	が最後<br>ところで<br>とたん<br>最中
高原{{c1::ならでは}}の新鮮な野菜を使ったサラダはいかがですか。	ならでは<br>だけあって<br>かぎり<br>ばかり
登山好きの彼は、日本アルプスは{{c1::もとより}}、ヨーロッパアルプスにも登っている。	もとより<br>とにかく<br>皮切りに<br>のみならず
おいしそうなケーキを食べようとした{{c1::ところ}}で、目が覚めてしまった。	ところ<br>ばかり<br>最中<br>おり
わが家の厳しい財政状態では１円{{c1::たりとも}}、無駄にできない。	たりとも<br>ほどでも<br>なりとも<br>くらいは
簡単な問題だからすぐ解ける{{c1::と思いきや}}、意外に厳しくて苦しんだ。	と思いきや<br>にしては<br>わりには<br>ときたら
連休中{{c1::とあって}}、観光地は、どこも人と車で混雑していた。	とあって<br>こととて<br>とはいえ<br>ことから
君の能力なら、きちんと勉強すれば合格できた{{c1::ものを}}、どうしてしなかったんだ。	ものを<br>ことから<br>ものだ<br>ことなしに
あんな気の弱い男に強盗なんて、{{c1::できっこない}}。	できっこない<br>できないこともない<br>できないにほかならない<br>できないまでのことだ
営業成績を{{c1::上げんがために}}、社員一同休みも取らずにがんばっている。	上げんがために<br>上げんばかりに<br>上げようと上げまいと<br>上げようにも
財政上の理由から、社員寮の新築計画は中止を{{c1::余儀なくされた}}。	余儀なくされた<br>するにはあたらない<br>せずにはいられない<br>ほかならない
君、新発売のゲーム、やってみた。おもしろいって{{c1::いったらない}}よ。	いったらない<br>きわまりない<br>ほかない<br>たまらない
彼のミスの後始末でみんな大変だった。あれだけ迷惑をかけたのだから、{{c1::謝らないではすまない}}だろう。	謝らないではすまない<br>謝らないこともない<br>謝らないものでもない<br>謝らずにはおかない
どれも同じ品質だというなら{{c1::安い}}にこしたことはない。	安い<br>安全性<br>大きさ<br>価格
研修中の１週間は、外出は{{c1::おろか}}電話もできなかった。	おろか<br>ともに<br>むしろ<br>どころか
試験の結果{{c1::次第では}}、もう一度クラスを編成しなおさなければならないかもしれない。	次第では<br>以上は<br>限りに<br>反面
あなたが悩んでいるなんて、周囲の人は想像{{c1::すら}}していないだろう。	すら<br>だけ<br>ばかり<br>ぐらい
選挙の結果{{c1::いかんでは}}、決まっていた開発が中止になる恐れもある。	いかんでは<br>にかかわらず<br>といえども<br>ならでは
試合を{{c1::来週}}にひかえて、会場周辺はあわただしい空気に包まれていた。	来週<br>先週<br>現在<br>１週間
映画での彼の役は通行人だから、{{c1::よほど}}注意して見ていないと見過ごしてしまう。	よほど<br>たしか<br>まさか<br>いまにも
結果は{{c1::ともかく}}、終わってほっとしている。	ともかく<br>ともすれば<br>とりわけ<br>どうにか
Ａ社は業績が伸びているのに{{c1::ひきかえ}}、我が社は業績が落ち込んでいる。	ひきかえ<br>あって<br>そくして<br>いたって
{{c1::なんとか}}して有名になりたいというのが、当時の私の夢でした。	なんとか<br>なんと<br>なんだか<br>なんとも
この絵は、数々の賞をもらっている彼女{{c1::ならでは}}の作品だ。	ならでは<br>きり<br>なければ<br>ばかり
老人は{{c1::ともすると}}家に閉じこもりがちになる。	ともすると<br>あたかも<br>かりに<br>せいぜい
国会は、この法案の成立を{{c1::めぐって}}紛糾した。	めぐって<br>関して<br>考えて<br>ついて
金を払ってしまったし、今更{{c1::やめよう}}にもやめられない。	やめよう<br>やめたい<br>やめられる<br>やめた
社長と{{c1::いえども}}、社員の個人のプライバシーを侵すことはできない。	いえども<br>いったら<br>いえば<br>いうと
彼は「やったあ」と大声で叫ぶ{{c1::なり}}、飛び出していった。	なり<br>際<br>時<br>より
４月下旬から５月上旬{{c1::にかけて}}花見を楽しむ人が多い。	にかけて<br>にとって<br>において<br>によって
負ける{{c1::ものか}}と、必死にがんばったからこそ、今の私があるのだ。	ものか<br>ものだ<br>ものが<br>ものを
何度調べてみても、異常は見当たらず、{{c1::いっこうに}}見当がつかない。	いっこうに<br>いったい<br>いつしか<br>いちがいに
話し合いは行われた{{c1::ものの}}、結局、合意には至らなかった。	ものの<br>ものだから<br>ものを<br>ものなら
クラスの全員が大学に合格した。林さん{{c1::にいたっては}}受けた学校すべてに合格したという。	にいたっては<br>にあっても<br>において<br>にきいては
夜中に{{c1::ただならぬ}}音がしたので、飛び起きた。	ただならぬ<br>なんとなく<br>ままならぬ<br>とっさに
彼の顔を見た{{c1::とたんに}}、心配事が吹き飛んだ。	とたんに<br>すぐ<br>やいなや<br>たちまち
景気がよくなっても、{{c1::たいして}}生活はかわらない。	たいして<br>いかにも<br>なまじ<br>いったん
緊急に呼び出され、せっかくの妻の料理も{{c1::食べかけで}}、あわてて家を出てきた。	食べかけで<br>食べながら<br>食べていて<br>食べついでに
努力したわりに、{{c1::よい結果が出ない}}。	よい結果が出ない<br>結果がよかった<br>結果は問わない<br>結果はわからない
この映画はストーリーといい、出演者といい、{{c1::とてもすばらしかった}}。	とてもすばらしかった<br>すとーりーのほうが重要だ<br>どちらがよかったのだろう<br>内容のほうがよかった
{{c1::こんなことをするなんて}}、どうかしている。	こんなことをするなんて<br>将来は医者になりたいので<br>これ以上ふとらないように<br>政府は事故の対策として
そこから見えたのは、なんのことはない、{{c1::普通の家}}だった。	普通の家<br>変わった家<br>特別な家<br>すてきな家
一度でも彼の踊りを見たら、彼のファンに{{c1::ならずにいられなくなる}}。	ならずにいられなくなる<br>ならずにおかない<br>なってはいられない<br>なってはすまない
かりに手術が成功したとしても、前と同じように生活できる{{c1::かどうかはわからない}}。	かどうかはわからない<br>かもしれない<br>はずだか<br>わけだ
厳しいことを言うということは愛情があるということに{{c1::ほかならない}}。	ほかならない<br>ほかでもない<br>ほかがない<br>ほかしかない
今後、被害の状況に応じて、しかるべき対策をとることに{{c1::なろう}}。	なろう<br>なれる<br>ねばならぬ<br>である
講義は{{c1::さっぱりわからないし}}、聞く気にならない。	さっぱりわからないし<br>さっぱりしていて<br>さっぱりむずかしいし<br>さほどむずかしくて
父が突然倒れて入院した。ことによると、{{c1::死んでしまうかもしれない}}。	死んでしまうかもしれない<br>回復してもいいかもしれない<br>死んでしまうにちがいない<br>回復するといいのだが
結婚式の{{c1::日取り}}が決まったので、さっそく案内状を出すことにした。	日取り<br>日課<br>月日<br>日程
彼の{{c1::もくろみ}}はことごとく成功し、あっという間に昇進した。	もくろみ<br>もうしで<br>ものずき<br>もうしぶん
一口に文学といっても、小説、詩など、いろいろな{{c1::ジャンル}}がある。	ジャンル<br>ケース<br>システム<br>パターン
きょうは思いのほか仕事が{{c1::はかどった}}から、残業せずに済みそうだ。	はかどった<br>ずれた<br>もうけた<br>ためらった
家賃が{{c1::滞る}}と、大家さんがいい顔をしない。	滞る<br>阻む<br>焦る<br>漂う
人類の長い歴史から見れば、一人の人間の命なんて{{c1::はかない}}ものだ。	はかない<br>もろい<br>そっけない<br>みっともない
人に注意しておいて自分が失敗するとは、実に{{c1::こっけいな}}話だ。	こっけいな<br>あやふやな<br>ありふれた<br>月並みな
これといって愛読書というものもありませんが、{{c1::強いて}}言えば、歴史小説や時代小説などですね。	強いて<br>例えて<br>促して<br>対して
何分不慣れな新入社員の{{c1::こととて}}、失礼があれば、どうかお許しください。	こととて<br>ことに<br>ことから<br>ことか
話し合いの結果{{c1::いかん}}では、計画を見直さざるを得ない。	いかん<br>ばかり<br>だけ<br>かぎり
稼ぐ{{c1::そばから}}つかってしまうので、貯金するどころではない。	そばから<br>ところに<br>ながらも<br>とたんに
父親{{c1::たる}}者、一家の長として、家族の幸せを守るのが当然だろう。	たる<br>ごとき<br>べき<br>とする
火山の大噴火でふもとの住民は、家は{{c1::のみならず}}、土地まで失ってしまった。	のみならず<br>おろか<br>はじめ<br>とわず
我々は、ともすると目先のことにとらわれて、全体的な様相を見逃す{{c1::きらい}}がある。	きらい<br>わけ<br>しだい<br>しまず
子供の教育のため{{c1::あれば}}金も時間も惜しまないという親が増えている。	あれば<br>きたら<br>すれば<br>いったら
一流企業{{c1::とはいえ}}、こう不況が長引くと、生産力が低下するのも当然だ。	とはいえ<br>ならば<br>とあって<br>といい
困難な状況{{c1::においても}}、なお理想を失わない彼の強さは、立派としか言いようがない。	においても<br>にとっても<br>にかけても<br>にしても
食中毒の患者が一人でも出れば、これは店の信用に{{c1::かかわる}}問題となる。	かかわる<br>いたる<br>わたる<br>かぎる
社長の挨拶を{{c1::かわきりに}}、重役たちのスピーチが続いた。	かわきりに<br>はじまりに<br>あいついて<br>さいごに
この問題には、何よりも実状に{{c1::促した}}対策が望まれる。	促した<br>至った<br>向いた<br>通じた
犯人だと断定するに{{c1::足る}}証拠が不十分で、警察はその男を逮捕できなかった。	足る<br>耐える<br>当たる<br>代わる
敵の攻撃を{{c1::ものともせず}}、兵士たちは勇敢に前進を続けた。	ものともせず<br>めぐって<br>ものにして<br>ものだから
不潔{{c1::きわまりない}}衛生環境の中での避難生活がすでに数ヵ月も続いている。	きわまりない<br>だらけの<br>あっての<br>にたえない
その子は幼い{{c1::なりに}}、両親の苦しい状況を察していた。	なりに<br>だけに<br>ばかりに<br>ゆえに
大学に入ってから{{c1::というもの}}、娘はアルバイトばかりしている。	というもの<br>ともなると<br>しだい<br>といって
この秘密がもれた{{c1::が最後}}、すべての努力が水の泡となるだろう。	が最後<br>や否や<br>かと思うと<br>なり
こんなにうるさく言うのは、君のための{{c1::思えば}}こそなんだ。	思えば<br>思ったら<br>思う<br>思うなら
この提案について、みなさまからのご意見を{{c1::うけたまわり}}たいと思います。	うけたまわり<br>おめにかけ<br>ぞんじあげ<br>もうしあげ
会社が総力をあげて取り組むことなしに、この難問を{{c1::解決することは不可能だ}}。	解決することは不可能だ<br>解決してほしい<br>解決できないはずがない<br>解決せざるを得ない
今夜のあなたは、{{c1::いつにもまして}}美しい。	いつにもまして<br>いつとはいわず<br>だれともなく<br>だれにしても
難しいことは難しいが、努力次第では{{c1::実現できないものでもない}}。	実現できないものでもない<br>実現させたいものだ<br>実現できそうもない<br>実現できるだろうか
ようやくたどり着いた山の頂上で飲んだビールのうまさ{{c1::といったらなかった}}。	といったらなかった<br>といってもよかった<br>といったところだ<br>というわけではなかった
島の住民の生活は、豊かとは言えないまでも{{c1::食べるには困らない状態だ}}。	食べるには困らない状態だ<br>苦しい状態にある<br>物が不足しがちだ<br>がんばらざるを得ない
この汚れさえ落とせば、元どおりにはならない{{c1::までも}}かなりきれいになりますよ。	までも<br>までに<br>よりも<br>までは
Ｔさんの子供時代の写真、ある{{c1::には}}ありましたが、あまりよく写っていませんよ。	には<br>のも<br>から<br>のに
彼は訓練のために100段{{c1::からある}}階段を毎日何回も上り下りしているそうだ。	からある<br>からには<br>からして<br>からこそ
先日の写真ができましたので、年末のご挨拶{{c1::かたがた}}お届けにうかがいます。	かたがた<br>かたわら<br>ながら<br>とともに
Ａ「横井さん、来週マニラに出張なさるそうですよ。」Ｂ「そうですか。マニラ{{c1::といえば}}、確か田中さんが行ってますよね。」	といえば<br>にせよ<br>といっても<br>にせよ
彼はあらゆる困難を{{c1::もの}}ともせず、人命救助のためならどこへでも出かけて行く。	もの<br>こと<br>わけ<br>はず
昔の父親というものは、父親{{c1::たるもの}}家族に弱みを見せてはいけないと思っていた。	たるもの<br>であれ<br>あっての<br>たりとも
専門家{{c1::じゃあるまいし}}、そんなことわかるわけないじゃありませんか。	じゃあるまいし<br>だけあって<br>のこととて<br>とあって
Ｋ氏は国交回復の交渉を{{c1::進める}}べく、Ａ国にひそかに入国した。	進める<br>進めよう<br>進め<br>進められる
今日のこの新しい門出にあたり、お二人の末永いお幸せをお祈りして{{c1::やみません}}。	やみません<br>なりません<br>たまりません<br>しょうがありません
Ｓ社は借金までして事業を広げたが、不景気で売上が伸びずついには倒産する{{c1::に至った}}。	に至った<br>べきだ<br>なりだ<br>きりだ
その件については、さきほど担当の方より私どもに十分{{c1::ご説明いただき}}ました。	ご説明いただき<br>説明いたし<br>ご説明され<br>ご説明申しあげ
毎年、休暇でヨーロッパ旅行とは{{c1::うらやましいかぎりだ}}。	うらやましいかぎりだ<br>うらやましいところだ<br>うらやましいとはかぎらない<br>うらやましいまでもない
たとえ未成年でも、意図があって相手を傷つけたものはそれなりに{{c1::罰せられるべきだ}}。	罰せられるべきだ<br>罰せさせるしかない<br>罰しかねない<br>罰するはずではない
今回新しく開発されたコンピューターのソフトは従来の情報社会に影響を{{c1::与えずにはおかないだろう}}。	与えずにはおかないだろう<br>与えることを余儀なくされるだろう<br>与えないではいられない<br>与えずにはいかない
長年にわたって築いてきた幸せが一瞬にして崩れ去ってしまった。これが{{c1::悲劇でなくて何だろう}}	悲劇でなくて何だろう<br>悲劇しかない<br>悲劇にはあたらないだろう<br>悲劇にすぎない
日本人の生活は表面的にはかなり近代化しているように見える。しかし、家庭の中にまで入り込んで眺めてみると、昔{{c1::ながらの}}伝統が様々なところに色濃く残っている。	ながらの<br>ずくめの<br>気味の<br>めく
大学の理想は何であろう。それは、卒業後もしぼむ{{c1::ことなく}}発展する学問的精神を養い、社会に出た後も伸びつづける弾力性のある頭脳を育てることにあると思われる。	ことなく<br>かぎりなく<br>はずなく<br>ともなく
動物だって親{{c1::もあれば}}兄弟も友だちもある。それを意味なく、一匹だけつかまえたりするものではない。	もあれば<br>にひきかえ<br>にかわり<br>に反して
一生のよい友だちを持つことは、時には運がある。よい友だちに{{c1::なり得る}}人でも、タイミングが悪ければ、互いに理解し合えないで別れてしまうこともある。	なり得る<br>なりかねる<br>なりがたい<br>なるばかりの
犯人を見かけたという情報もあること{{c1::から}}、警察は付近の聞き込みを行っている。	から<br>に<br>より<br>さえ
経済界の首脳３者は景気は徐々に回復に向かいつつある{{c1::との}}認識で一致した。	との<br>では<br>とは<br>と
私は{{c1::どちらか}}というと、皆で騒ぐより、一人でいる方が好きだ。	どちらか<br>かわりに<br>くらべて<br>反面で
彼女は怒っているのか、挨拶{{c1::はおろか}}私の方を見ようともしなかった。	はおろか<br>なくして<br>とばかりに<br>といえども
新しい知事の誕生{{c1::を契機として}}、各地方自治体の政策の見直しが始まった。	を契機として<br>を限りに<br>を通して<br>を中心として
彼は会の間じゅう終始上機嫌で、今日ばかりは嬉しさをかくし{{c1::きれない}}様子だった。	きれない<br>つくせない<br>つけない<br>ぬけない
私は勤勉ではないが、{{c1::かといって}}、それほど勉強がきらいというわけでもない。	かといって<br>といい<br>というのは<br>というのも
彼は３７年間勤めつづけた銀行を今日{{c1::を限りに}}退職することになった。	を限りに<br>をよそに<br>を末に<br>をきっかけに
彼はいつも愛想がよかった。それは子供ながら、彼の生きんが{{c1::ための}}手段であった。	ための<br>ものの<br>わけの<br>ことの
夏休みに私が帰宅したら、待ってました{{c1::ばかりに}}姉に子守りを頼まれてしまった。	ばかりに<br>ばかりか<br>わけの<br>ことの
「さあ、冗談{{c1::はぬきにして}}、もっとまじめに話し合いましょう。」	はぬきにして<br>次第で<br>をもとにして<br>に先立って
彼の外国旅行の時の失敗談は、いつ聞いてもおかしいといったら{{c1::ない}}。	ない<br>あろう<br>あれ<br>あらぬ
彼は、１０年{{c1::に及ぶ}}逃亡生活に疲れ果てて、ついに死を選んだのであった。	に及ぶ<br>に足る<br>にまして<br>に促した
このような時ですから、今後は何が{{c1::起ころうと}}、驚かないでください。	起ころうと<br>起ころうか<br>起これ<br>起これば
私のような者がこのように立派な賞をいただけるとは、光栄{{c1::の至り}}でございます。	の至り<br>の次第<br>が最後<br>の上
家庭電気製品の普及{{c1::に伴って}}、主婦たちは次第に家事労働から解放された。	に伴って<br>にひきかえ<br>にあたって<br>に則して
これからは我が社も若い世代{{c1::向きの}}商品を開発していきたいと考えております。	向きの<br>ぬきの<br>つきの<br>きりの
優勝パレードが進んでいくと、窓{{c1::という}}窓から人々の歓声が上がった。	という<br>といい<br>にせよ<br>なり
先生のお母様のことは、子供のころよりよく{{c1::存じ上げております}}。	存じ上げております<br>存じ上げました<br>存じました<br>存じます
「毎日、{{c1::お暑う}}ございますが、お元気でいらっしゃいますか。」	お暑う<br>お暑く<br>お暑い<br>お暑くて
彼らはみな山登りのベテランなのだから、一時的に連絡がなかったにしても{{c1::あんな心配しなくてもよかったのに}}。	あんな心配しなくてもよかったのに<br>そんなに心配したのだろう<br>どんなに心配したことか<br>こんなに心配してもよかった
社員を道具のように考えている社長の下で、どうして社員が意欲的に仕事を{{c1::することができよう}}。	することができよう<br>しないのだろう<br>しないわけにはいかないのか<br>することはないのか
彼はタイ語ができなのに、タイの地方都市に行ったのだから、今ごろは{{c1::さぞ、困っているだろう}}。	さぞ、困っているだろう<br>案外、上手になったかもしれない<br>よほど、困ったのだろう<br>きっと、タイ語が上手になっただろう
洋服は組み合わせの利くものを持つのが賢明だ。たくさんあればいい、{{c1::というものでもない}}。	というものでもない<br>といってもいい<br>というはずではない<br>というものだ
地震災害などあの場合を考えると、東京に集中した首都機能を地方に{{c1::分散させるべきだと思う}}。	分散させるべきだと思う<br>分散を余儀なくさせると思う<br>分散するものだと思う<br>分散することはないと思える
林氏は、若い日々を過ごしたロンドンでの留学生活がよほど楽しかった{{c1::とみえて}}、晩年になってからもよく話題にしていた。	とみえて<br>としても<br>はずで<br>ものか
芸術ではいろいろな活動の相互乗り入れが作品に活力を与える。例えば、小説{{c1::にしても}}、ただ黙読するのでなく、朗読してみると、人の心にじかに訴えてくることがある。	にしても<br>にあたって<br>というと<br>としても
ほかの人が{{c1::行こうが}}行くまいが、私には関係ないことです。私はあくまでも自分で、行かないと、決断したのですから。	行こうが<br>行ったが<br>行くが<br>行けば
親子以外の人間関係は、制度的にも心理的にも、必要{{c1::とあれば}}、精算することができる。しかし、変化の激しい現代社会の中にあっても、親子関係だけは、いまだに精算のできない、特殊な人間関係である。	とあれば<br>につけ<br>といえども<br>にせよ
現代は、マルチメディアの時代である。そんな時代においては、文字の役割は前ほど重要でなくなるのではないかと{{c1::思わざるを得ない}}。	思わざるを得ない<br>思うわけではない<br>思うとは限らない<br>思わないではおかない
「ゴミを捨てるな」という看板があるにもかかわらず、捨てる人が後を{{c1::たたない}}。	たたない<br>すぎない<br>おかない<br>切らない
どの建物も、それぞれの外観が町並みに見事に{{c1::調和して}}いて美しい。	調和して<br>同調して<br>強調して<br>調整して
一連の犯行が同一グループによるものであることは、もはや疑う{{c1::余地}}がない。	余地<br>余分<br>余裕<br>余暇
現地では専門の{{c1::ガイド}}が、皆様を名所旧跡にご案内する予定です。	ガイド<br>コーチ<br>ゲスト<br>プロ
皆が並んでいるのに、後から来て割り込むとは何て{{c1::ずうずうしい}}人なのだろう。	ずうずうしい<br>わずらわしい<br>はなはだしい<br>なれなれしい
朝から電話はかかるし、来客はあるしで、{{c1::ろくに}}食事もとっていないんですよ。	ろくに<br>おもに<br>ふいに<br>まれに
その付近一帯を捜し回ったが、逃げたサルの行方は{{c1::いぜん}}不明のままである。	いぜん<br>とかく<br>かねて<br>いっそ
生まれたばかりの赤ちゃんの{{c1::すこやかな}}成長を願わない親はいない。	すこやかな<br>ゆるやかな<br>清らかな<br>しとやかな
健康のため、1日に30品目以上の食品をとるよう{{c1::心がけて}}います。	心がけて<br>手がけて<br>こころざして<br>かえりみて
事件の{{c1::真相}}を解明すべく、警察は異例の大捜査を行った。	真相<br>真理<br>真実<br>事実
今日は大学から合格の通知がくる日なので、朝からじっとして{{c1::いられない}}のです。	いられない<br>たまらない<br>やまない<br>ならない
いじめの問題はひとり東西中学校{{c1::のみならず}}、全国の学校の問題である。	のみならず<br>どころか<br>ほかならず<br>にひきかえ
今回の優勝は、サッカー部の部員みんなの努力の成果{{c1::にほかならない}}。	にほかならない<br>にかぎらない<br>にともなわない<br>しかない
ベルが鳴ったか{{c1::鳴らない}}かのうちに、花子は玄関に飛び出した。	鳴らない<br>鳴る<br>鳴って<br>鳴ろう
政府は10万人の空腹を満たす{{c1::に足る}}食料をただちに空輸した。	に足る<br>に過ぎる<br>に至る<br>にそう
委員たちは午前１０時から午後２時まで、昼食{{c1::ぬきで}}話し合いをづづけた。	ぬきで<br>たりとも<br>がてら<br>かたがた
誰もいない部屋まで暖房するなど、それこそ無駄{{c1::というもの}}だ。	というもの<br>というふう<br>といったこと<br>といった次第
Ｋ博士の言葉は若い人々の心にいつまでも{{c1::消えることなく}}、希望の灯をともしつづけた。	消えることなく<br>消えても<br>消えなくて<br>消えるまで
A校の運動部では、先輩にむかって反抗{{c1::しょう}}ものなら、ひどい目にあわされる。	しょう<br>しそう<br>する<br>して
会長ひとりの判断でものごとを決定することは、制度{{c1::上}}不可能となっている。	上<br>下<br>中<br>前
災害地の復興は、住民の協力{{c1::をぬきにしては}}、成り立たない。	をぬきにしては<br>をもって<br>をめぐり<br>をもとに
歓迎会のスピーチのことですが、Aさんなら引き受けて{{c1::ないこともない}}んじゃないですか。	ないこともない<br>そうではない<br>ようもない<br>てやまない
３０年の間、お世話になりましたが、本日{{c1::をもって}}退職いたします。	をもって<br>をはじめ<br>に際し<br>により
それぞれの学校の実情{{c1::に即した}}方法で、問題を解決していかなければならない。	に即した<br>に当てた<br>における<br>に関した
こんな事故ははじめてのこと故、警察とした{{c1::ところで}}どうしようもなかったのだろう。	ところで<br>ことが<br>もので<br>ばかりに
不景気{{c1::に加え}}、今回の不作がこの地方の農家にいっそうの打撃を与えた。	に加え<br>を通じ<br>をはじめ<br>にこたえ
30年ぶりに祖国を訪れることができたのは、感激{{c1::の極み}}であった。	の極み<br>の果て<br>のもと<br>の当たり
昔の諺にあるとおり、地震{{c1::ほど}}こわいものはない。	ほど<br>まで<br>であれ<br>にしろ
ふだんの部長の考え方{{c1::から}}すると、そんな企画はとても通らないと思うよ。	から<br>に<br>まで<br>さえ
田中会長の奥様は、あの紫の和服を{{c1::お召しになった}}方でございます。	お召しになった<br>着させた<br>召し上がった<br>お召した
予想に反した事態になったのだから、社長は前回の会議における発言を{{c1::訂正せざるを得ないだろう}}。	訂正せざるを得ないだろう<br>訂正するには及ばない<br>訂正するきらいがある<br>訂正せずにいるだろう
私の不注意で祖父の大切な花瓶を壊してしまったのだから、{{c1::謝らないではすまない}}。	謝らないではすまない<br>謝らないではおかない<br>謝らずにはおかない<br>謝らないですむ
今回の事態に迅速に対処するには、根本的な法律の改革なしには{{c1::可能とはいえない}}。	可能とはいえない<br>可能だろう<br>不可能だ<br>可能かもしれない
タンさんが猿の真似をしてみせたが、あまりのおかしさに皆{{c1::笑わずにはいられなかった}}。	笑わずにはいられなかった<br>笑いをものともしなかった<br>笑うわけがなかった<br>笑うわけにはいかなかった
当社の新宿にあります二支店は、この度、都合により統合{{c1::させていただくことになりました}}。	させていただくことになりました<br>してさしあげることにしました<br>していただくことになりました<br>してくださることでございます
私たち人間の生活は、他の人々と互いに交わり合うこと{{c1::なしには}}成立しない。	なしには<br>ばかりには<br>までもなく<br>でなく
日本人は中学・高校{{c1::を通じて}}、6年間も英語を学んでいる。にもかかわらず、道を聞かれて教えることができる程度に話せる人は少ない。	を通じて<br>に至って<br>をおいて<br>にかかり
私たちはあることを人に説明しようとするとき、わかってもらうためにいろいろな工夫をする。その工夫を重ねること{{c1::により}}、私たち自身の理解もさらに深まるのである。	により<br>のために<br>にして<br>なりに
教育心理学者が明らかにした{{c1::ところによると}}、3歳の子供の好奇心は非常に旺盛だという。子供の好奇心は、ものごとを学ぶ原動力である。	ところによると<br>ものでは<br>こととて<br>ことは
転勤でブラジルに行くことになった。外国に住む{{c1::からといって}}と、張り切ってポルトガル語を勉強し始めた。だが、その言葉の環境のないところで外国語を学ぶのは難しい。	からといって<br>にしても<br>とはいえ<br>からには
お知らせいただければ、駅までお迎えに行きました{{c1::ものを}}。	ものを<br>ことを<br>はずを<br>ところを
今、ちょうどコーヒーを入れた{{c1::ところ}}なんだけど、一緒に飲まないかい。	ところ<br>とき<br>もの<br>わけ
この混迷の時代に国民を指導できるのは、我が党を{{c1::おいて}}、他にない。	おいて<br>よって<br>とって<br>なくして
大会社の社長{{c1::ともなると}}、総理大臣と付き合う機会も多々ある。	ともなると<br>としたら<br>にしたら<br>ならでは
これが大事なものだということは、説明する{{c1::までもなく}}、よくご存じですね。	までもなく<br>としたら<br>ならば<br>わけなく
その小説は発表される{{c1::やいなや}}、たちまち１００万部を売り尽くした。	やいなや<br>すぐに<br>とたんに<br>まもなく
彼は私が転んだのを見ても、助け起こす{{c1::どころか}}、薄笑いさえしていた。	どころか<br>ところで<br>までもなく<br>わけか
１０万円なんてあなたに{{c1::すれば}}わずかなお金でしょうが、私には大金です。	すれば<br>よれば<br>いえば<br>見れば
電車で老人が立っているのに誰も席をゆずらない。私は見るに{{c1::見かねて}}、座っている若者を立たせた。	見かねて<br>見えずに<br>見ないで<br>見ていて
男は「さっさと出ていけ」と言わん{{c1::ばかり}}に、ドアを指差した。	ばかり<br>ほど<br>だけ<br>よう
うーん、いい香りだ！　さすがワインの本場{{c1::ならでは}}ですね。	ならでは<br>かぎり<br>だから<br>こそ
いくらお金が欲しい{{c1::からといって}}、そんなに無理して働いたら病気になってしまいますよ。	からといって<br>からこそ<br>というから<br>のだから
このビルの建設を{{c1::めぐって}}、５つの建築会社が落札を争っている。	めぐって<br>たいして<br>もとめて<br>かんして
長い間の努力にも{{c1::かかわらず}}、彼女はついに歌手として成功しなかった。	かかわらず<br>せいで<br>おかげで<br>およばず
今朝、新聞を読む{{c1::ともなく}}見ていたら、私の友人の写真が出ていて驚いた。	ともなく<br>はしから<br>ことなく<br>ばかりで
この景気ではボーナスは{{c1::おろか}}、月給だって全額出るかどうかあやしい。	おろか<br>さらに<br>ともかく<br>わずか
マスコミに知られた{{c1::上は}}、もう公表するしかありません。	上は<br>ためには<br>後で<br>からこそ
あなたが大学に行こうと{{c1::行くまい}}と、私には関係ない。あなたの問題ですよ。	行くまい<br>行きたい<br>行かざる<br>行かない
頭のいい彼女{{c1::こと}}だ。きっといい解決方法を考えるに違いない。	こと<br>もの<br>ところ<br>わけ
この教育の重要性は、どんなに強調しても強調{{c1::しすぎる}}ことはない。	しすぎる<br>しない<br>した<br>しかねない
子どもじゃ{{c1::あるまい}}し、そんなことで泣くんじゃない。	あるまい<br>あろう<br>ない<br>なかった
その病人には医師が三人つき{{c1::っきり}}で看病に当たっている。	っきり<br>ぱなし<br>つつ<br>ながら
どんな秘密も、彼女に話した{{c1::が最後}}、会社中に広がってしまう。	が最後<br>ものなら<br>わけだと<br>まもなく
子どもたちは、私が天ぷらを揚げる{{c1::そばから}}食べ、私の分がなくなってしまった。	そばから<br>うちに<br>とたんに<br>ばかりで
彼は運転はうまいが、少しスピードを出しすぎる{{c1::きらい}}がある。子どもも一緒だし、私が運転することにしよう。	きらい<br>すき<br>悪さ<br>気味
ビザの期限が切れたらから、国に帰らざるを{{c1::えない}}。	えない<br>ならない<br>しかたない<br>いけない
彼は自分のしたことがどれだけ人を苦しめているか、知ろうとも{{c1::しない}}。	しない<br>している<br>知れない<br>知らない
いくら普段は冷静な私だって、それを聞いてびっくり{{c1::せずにはいられません}}。	せずにはいられません<br>しなくてはいけません<br>しようがありません<br>してもかまいません
外国語を学ぶのは、やる気さえあれば何歳からでもできる。しかし、できれば若いうちにやるに{{c1::こしたことはない}}。	こしたことはない<br>しかたがない<br>はおよばない<br>さしつかえない
コンピューターがそんなミスを犯すなんて、万に一つも{{c1::ありえない}}。	ありえない<br>あるかもしれない<br>ありうるだろう<br>ありえなくもない
子どもを叱らずに甘やかすことが、子どもを愛することだと思っている親は多い。その結果、子どもは２歳に{{c1::なるかならずで}}、すっかりわがままな王様のようになってしまう。	なるかならずで<br>なってみたら<br>なったとたんに<br>なるやいなや
混んだ駅で歩きながらタバコを吸う人がいる。この間、タバコの火が女の子の目にあたってやけどさせるという事故もあった。全面的に禁煙にしろとは{{c1::言わないまでも}}、決まった場所だけで吸ってほしいものだ。	言わないまでも<br>言うまでもなく<br>言うにおよばず<br>言わないことではなく
彼女の魅力は、その美しさはもちろんだが、会話のおもしろいことで、一度彼女と話した人は彼女を好きに{{c1::ならずには}}いられない。	ならずには<br>ならなくては<br>なるわけには<br>なっては
小学校入学を目前にして男の子が信号無視の乗用車にひき殺され、犯人はそのまま逃げてしまった。その父親は「何年かかっても、犯人を探し出さずには{{c1::おかない}}ぞ」と、会社を辞めて、犯人探しを始めた。	おかない<br>ならない<br>いけない<br>やらない
都会に出た娘が事件を起こしたために、彼女の田舎の実家にはマスコミが連日押しかけてきた。そのため一家は引っ越しを{{c1::余儀なく}}された。	余儀なく<br>さりげなく<br>しかたなく<br>いやおうなく
彼は会社勤めの{{c1::かたわら}}、専門学校に通って通訳の資格を得た。	かたわら<br>ついでに<br>しながら<br>ともに
このホテルは高い{{c1::だけあって}}、部屋もサービスも素晴らしいですね。	だけあって<br>というのは<br>とすれば<br>わりには
９０歳という高齢にも{{c1::かかわらず}}、彼の創作意欲はおとろえを見せない。	かかわらず<br>かけては<br>ほかならず<br>かまわず
あなたには気に入らなくても、私には私{{c1::なりの}}やり方があるのです。好きにさせてください。	なりの<br>どおりの<br>だけ<br>ごとき
今日は社長と社員という遠慮は{{c1::ぬきに}}にして、大いに飲もうじゃないか。	ぬきに<br>あとに<br>なく<br>取って
どんなに新しい電卓が出ても、私は昔{{c1::ながらの}}そろばんで計算しています。	ながらの<br>ままの<br>はものとより<br>みたいな
彼女は以前にも{{c1::まして}}きれいになったね。恋でもしているのかな。	まして<br>ますます<br>くらべて<br>おとらず
いくら安くなった{{c1::とはいえ}}、一戸建ての家は我々にはとても手が出ない。	とはいえ<br>ゆえに<br>けれど<br>そうだが
電車で騒いでいる子に注意したら、その母親が「よけいなお世話よ」とにらむんだ。まったく「この親{{c1::にして}}この子あり」だと思ったよ。	にして<br>として<br>ゆえに<br>なら
あなたのことを{{c1::思えば}}こそ、こうやって注意するのよ。素直にお聞きなさい。	思えば<br>思った<br>思う<br>思わず
私の本当の気持ちが、お前なんかにわかる{{c1::もの}}か。	もの<br>こと<br>はず<br>ところ
その薬の副作用による死亡者が１００人を越えるに{{c1::あたって}}、厚生省もようやく調査に立ち上がった。	あたって<br>いたって<br>おいて<br>かんして
うちの女房{{c1::ときたら}}、みそ汁も満足に作れないんだから。	ときたら<br>としては<br>にしたら<br>にしては
自分が病気になってみて、はじめて患者の苦痛が身{{c1::をもって}}わかった。	をもって<br>に感じて<br>を通して<br>にとって
何かを勉強したいというより、ただ一流大学に入らんが{{c1::ために}}勉強している人が多い。	ために<br>ように<br>せいで<br>しようと
難民はただ飢え{{c1::のみ}}ならず、伝染病にも苦しんでいる。	のみ<br>しか<br>ばかり<br>だけ
１２月とも{{c1::なると}}、５時にはもうすっかり暗くなりますよ。４時には子どもを帰しましょう。	なると<br>すれば<br>くれば<br>いると
子どもが独立して、やっと自分の好きなことができると{{c1::思いきや}}、今度は夫が病気になってしまった。	思いきや<br>思っても<br>思えば<br>思ったばかりに
一度お支払いいただいたお金は、理由の{{c1::いかん}}にかかわらずお返しできません。	いかん<br>ゆえ<br>どのよう<br>よしあし
そんなこと、できる{{c1::ものなら}}やってごらん。どうせ、できやしないから。	ものなら<br>ことなら<br>ところなら<br>はずなら
病院長は暗く{{c1::なりがちな}}病院の待合室に、季節の花をかざることにした。	なりがちな<br>なっている<br>なりかけた<br>なりそうな
この地下室は、一年を{{c1::つうじて}}１０度以下なので、ワインを貯蔵している。	つうじて<br>とおって<br>つらぬいて<br>かけて
医者が患者の秘密をもらしたなんて。医者として{{c1::あるまじき}}行為だ。	あるまじき<br>あるべき<br>ありがちな<br>ありそうな
私の故郷の美しい山々を、ぜひ先生にも{{c1::お目にかけ}}たいものです。	お目にかけ<br>ごらんになり<br>拝見し<br>お目にかかり
私の給料が彼の半分だって？　それは不公平と{{c1::いうもの}}だ。	いうもの<br>いうわけ<br>いうばかり<br>いいがち
こんなことをするなんて、彼の人間性を{{c1::疑わざるをえない}}。	疑わざるをえない<br>疑いはしない<br>疑わずにはおかない<br>疑わずにいない
彼は目立たない学生だが、よく勉強している。１番になったからといって驚くには{{c1::あたらない}}。	あたらない<br>あたいしない<br>たえない<br>しかない
政府の遅い反応がたくさんの犠牲者を出した。これは人災以外の{{c1::何ものでもない}}。	何ものでもない<br>何でもありうる<br>何でもない<br>何ともいえない
彼はかっとなりやすい。特に酒を飲んで怒ったときには人殺しだって{{c1::やりかねない}}。	やりかねない<br>やりえない<br>やりかねる<br>やるに相違ない
当たり前のことをしただけです。お礼には{{c1::およびません}}よ。	およびません<br>いりません<br>ありません<br>かまいません
目的もなく大学に入った{{c1::ところで}}、４年間無駄にするだけだ。受験する前に大学で何をやりたいか、よく考えなさい。	ところで<br>とはいえ<br>がゆえに<br>ものの
以前は内気な日本人にとって人の前で歌を歌うのは恥ずかしいことでした。しかしカラオケがはやって以来、マイクを握ろう{{c1::ものなら}}、なかなか手放さない人も増えました。	ものなら<br>と思いきや<br>とすれば<br>が最後
この団地の中には、スーパーマーケットはもとより、郵便局、銀行、幼稚園、病院、はては葬儀場{{c1::に至るまで}}そろっている。つまり死ぬまでこの中だけで過ごせるわけだ。	に至るまで<br>はおろか<br>もさることながら<br>にしたところで
このコンピューターはもうすぐ、もっといい機種が出るはずです。今お持ちの機械がこわれた{{c1::にしても}}、買うものはもう２，３か月待った方が良いと思いますよ。	にしても<br>ものなら<br>とあっては<br>ときたら
この病気は治らないとはいえ、注意さえすればほとんど普通の生活を送ることができます。でも注意を守らないと命に{{c1::かかわる}}場合もありますよ。	かかわる<br>あたいする<br>関する<br>至る
昔は親の言うことに反抗しよう{{c1::もの}}なら、げんこつが飛んできたものだ。	もの<br>こと<br>ところ<br>とする
このレストランの味は{{c1::さる}}ことながら、食器がまた素晴らしいですね。	さる<br>わるい<br>いい<br>とる
政府から大量の米が被災地に届けられた。{{c1::といっても}}一人あたりでは、茶碗１杯にすぎない。	といっても<br>というのに<br>というのは<br>というより
今世紀最大のピアニストと言われる{{c1::だけあって}}、彼の演奏には聴衆は皆感動した。	だけあって<br>だけで<br>くらいで<br>ほどで
彼らがあの時代に豊かな生活を送っていた{{c1::とすれば}}、すぐれた農耕技術を身につけていたはずだ。	とすれば<br>ともすれば<br>としては<br>とにかく
男達は毎日汗とほこり{{c1::まみれ}}になって、鉄道工事を急いだ。	まみれ<br>さえ<br>ずくめ<br>だけ
わが校は、男女・年齢を{{c1::問わず}}、どなたでも入学できます。	問わず<br>聞かず<br>言わず<br>かかわらず
何があったに{{c1::しろ}}、そんなに泣いてばかりいたらだめよ。	しろ<br>しては<br>しようが<br>したら
試験に落ちたことを知った彼女は、今にも泣き出さん{{c1::ばかり}}だった。	ばかり<br>くらい<br>よう<br>ほど
初めて作ったもの{{c1::にしては}}、よくできていますよ。	にしては<br>として<br>というと<br>といっては
山で道に迷っていたら、上空をヘリコプターが飛んできた。私は声を{{c1::かぎりに}}助けを求めた。	かぎりに<br>ぎりぎりに<br>さいごに<br>いっぱいに
いくら裕福でも、親の愛情{{c1::なくして}}、子どもは幸せと言えるのだろうか。	なくして<br>ないでは<br>ならずに<br>ないとは
お金のことは{{c1::ともかく}}として、今は好きな仕事ができるだけで幸せです。	ともかく<br>一方<br>とかく<br>まあまあ
出発に{{c1::先立って}}少し注意を申し上げます。パスポートはなくさないよう……。	先立って<br>先走って<br>したがって<br>前もって
私が無理なお願いをした{{c1::ばかりに}}、あなたにご迷惑をかけてしまいましたね。	ばかりに<br>ばかりで<br>だけに<br>だけあって
この辺で、アパートを借りるとなると、４万から５万円{{c1::といったところ}}ですね。	といったところ<br>ということ<br>としたところ<br>としたこと
世界中で毎年１００万人{{c1::あまり}}人が、飢えで命を落としている。	あまり<br>からの<br>よりの<br>までの
「あの仕事、終わりましたか」「途中で急用が入って、まだ{{c1::やりっぱなし}}です」	やりっぱなし<br>やりかけ<br>やりっきり<br>やったまま
日本で暮らして行く{{c1::上で}}大事なことは、他人とあまり違うことをしないことです。	上で<br>以来<br>最中で<br>ところで
T市の夜祭りは、真夜中から夜明けに{{c1::かけて}}にぎやかに繰り広げられる。	かけて<br>わたって<br>通して<br>そって
どこに行く{{c1::ともなく}}歩いていると、いつの間にか大きな寺の前に来ていた。	ともなく<br>が早いか<br>わけもなく<br>つもりで
明日の模擬試験は、時間も内容も本番の試験に{{c1::即して}}行います。	即して<br>よって<br>まねして<br>同様に
この風邪はほうっておくと、肺炎になる{{c1::おそれ}}があります。入院した方がいいですね。	おそれ<br>気味<br>向き<br>おびえ
田舎から送ってきたりんごです。一つ{{c1::あがって}}みてください。	あがって<br>さしあげて<br>なさって<br>お食べして
がんばって駄目だったのならあきらめるが、電車の事故で試験が受けられなかったなんて、あきらめようにも{{c1::あきらめきれない}}。	あきらめきれない<br>あきらめられる<br>あきらめかねない<br>あきらめるほかない
二度とあのような悲惨な戦争が起きないことを、私どもは願って{{c1::やみません}}。	やみません<br>やめません<br>とめません<br>とまりません
あの政治家は「私は選挙違反はやっていない」と言い続けたが、証拠をつきつけられると「妻がやったことだ」と言い出す{{c1::始末だ}}。	始末だ<br>終末だ<br>結果だ<br>最後だ
彼はいわば天才であって、誰もが努力して彼のようになれる{{c1::わけではない}}。	わけではない<br>はずがない<br>どころでない<br>わけがない
オリンピックに出ることが長年の彼の夢だった。出場が決まってどんなに喜んだか想像に{{c1::かたくない}}。	かたくない<br>むずかしい<br>やさしい<br>わからない
2年前私がこの国に来た時は、まわりの人の声はうるさい音に{{c1::すぎなかった}}。それがある日突然、意味のある言葉として聞こえてきた。	すぎなかった<br>相違なかった<br>たえなかった<br>聞こえなかった
山に登ったところ、山頂はﾎﾃﾙやおみやげ屋で町のようになっていた。なぜ静かな山をそのままに{{c1::せずにはおかない}}のだろうか。	せずにはおかない<br>しないでもない<br>しかねない<br>せざるをえない
お金さえあれば何でもできるわけではない。でも、何をする{{c1::にせよ}}、全然お金がなければ、やはり何もできないと思う。	にせよ<br>にもまして<br>までもなく<br>ところで
彼は、すべてに世話を焼きたがる母親と一緒にいる限り、自分は結婚もできないと思った。それで就職する{{c1::やいなや}}、部長に地方への転勤を願い出た。	やいなや<br>とたんに<br>かしないかのうちに<br>そばから
交通事故で死ぬ人が1年で1万人を越えた。せまい日本でこれ以上車を増やす{{c1::べきではない}}と思う。でも車が売れないとますます不景気になるかもしれない。どうすればいいのだろう。	べきではない<br>べくもない<br>べしだ<br>べからざること
「一人暮らしがしたい」と言うから、アパートを借りてやった{{c1::ものの}}、ちゃんと暮しているかしら。	ものの<br>もので<br>ものを<br>ものは
今日はボーナス後の日曜日{{c1::とあって}}、デパートは大変な人出だ。	とあって<br>としては<br>といって<br>だからといって
外国旅行も3回目{{c1::ともなれば}}、だいぶゆとりが出てきましたね。	ともなれば<br>ともすれば<br>ともあれ<br>のところを
散歩{{c1::がてら}}、スーパーに寄ってパンを買ってきた。	がてら<br>ついで<br>とちゅう<br>ながら
息子は家族の心配を{{c1::よそに}}、仕事もしないでゆうゆうと遊んでいる。	よそに<br>そとに<br>うえに<br>あとに
頭が痛いのなら無理しないで、薬を{{c1::飲むなり}}早く寝るなりしなさい。	飲むなり<br>飲むと<br>飲むや<br>飲んだり
あの人はいい人ではあるが、社長{{c1::としては}}力不足である。	としては<br>について<br>によって<br>においては
本日は皆様おいそがしい{{c1::ところ}}を、こんなにお集まりいただきまして、ありがとうございます。	ところ<br>とき<br>もの<br>こと
彼は楽器なら何{{c1::であれ}}、じょうずに弾くことができる。	であれ<br>であり<br>としても<br>をしても
100点をとれとは言わない{{c1::までも}}、せめて70点は取らないと合格しないよ。	までも<br>までに<br>までは<br>まで
病気が治った{{c1::とはいえ}}、しばらくは運動やお酒はひかえなさい。	とはいえ<br>としては<br>ときたら<br>にしては
歯が痛くて、ごはんを{{c1::食べよう}}にも食べられない。	食べよう<br>食べて<br>食べたい<br>食べる
いまさらどんなに後悔した{{c1::ところで}}、失敗を元に戻すことはできない。	ところで<br>はずが<br>ところが<br>ことでも
私の名誉に{{c1::かかわる}}問題です。お金で済ませないで、きちんと謝ってください。	かかわる<br>応じる<br>限る<br>際する
給料日まであと千円しかない。もう1円{{c1::たりとも}}無駄づかいできない。	たりとも<br>になるまで<br>だけなら<br>どころか
その危険性は何度も指摘されていた。今度の事故は起こる{{c1::べく}}して起こったことだ。	べく<br>べき<br>ために<br>はずに
デパートのドアが{{c1::開くや}}いなや、客がどっとなだれ込んだ。	開くや<br>開いて<br>開いたら<br>開くと
その光景を一目見る{{c1::なり}}、かの除は恐怖で倒れてしまった。	なり<br>とたん<br>が最後<br>そばから
食べる物がなくて死ぬ人がいる{{c1::一方}}で、日本のように食べ物を捨てている国もある。	一方<br>かたわら<br>片方<br>半分
他人のやり方は気にしないで、あなたはあなた{{c1::なりに}}がんばればいいんですよ。	なりに<br>さえ<br>しか<br>ほどに
彼女の美しさは、そこにいたすべての人の目にひきつけずに{{c1::おかなかった}}。	おかなかった<br>余儀なくした<br>あたいした<br>あたらなかった
責任者みずから{{c1::謝らない限り}}、他の人がいくら謝っても許さない。	謝らない限り<br>謝る限り<br>謝ろうが<br>謝るにかかわらず
いつも用心深い妻がドアを開けっ{{c1::ぱなしで}}出かけている。どうしたのだろう。	ぱなしで<br>きり<br>まま<br>あげく
女性の進学率の上昇に{{c1::ともなって}}、結婚の年齢も遅くなっている。	ともなって<br>もとづいて<br>わたって<br>関して
けちな人に{{c1::限って}}、他の人のことを「あいつはけちだ」と言うものだ。	限って<br>ついて<br>関して<br>対して
大人だって急に酒を飲むと死ぬことがある。子どもに酒を飲ませてはいけないのは{{c1::いうまでもない}}。	いうまでもない<br>いえなくもない<br>いわない方がいい<br>いわないでもない
子どもなら皆かかる病気です。すぐ治りますから、ご心配には{{c1::およびません}}。	およびません<br>かけません<br>さしつかえません<br>なさいません
国民の命を見殺しにした政治家にはげしい怒りを{{c1::禁じえなかった}}。	禁じえなかった<br>禁じなかった<br>禁じられた<br>禁じていなかった
どうしても貸してくれというなら{{c1::貸さないでもない}}が、何に使うのかね。	貸さないでもない<br>貸すこともない<br>貸すわけでもない<br>貸さないわけがない
いくらダイエット中でも、目の前にこんなごちそうを出されたら{{c1::食べずにいられない}}。	食べずにいられない<br>食べてはいられない<br>食べないではおかない<br>食べるわけにはいかない
「子ども時代は思いきり遊ばせた方がいい」と、皆思っている。ところが、自分の子どもの{{c1::こととなると}}、「少しでも早く勉強を始めさせた方がいいのでは」と不安にかられてしまう。	こととなると<br>ことをみると<br>ことにすれば<br>ことであろうと
オオカミが人間の少女を育てたという話は、はたして本当だろうか。たとえオオカミに育てられた{{c1::からといって}}、人間の足や目の働きがオオカミのようになるとは考えられない。その少女を拾った人の想像ではあるまいか。	からといって<br>からというもの<br>のではあるまいし<br>にもかかわらず
彼は静かに演奏を終えた。会場は一瞬シーンとなったが、次の瞬間、会場が{{c1::割れんばかりの}}拍手がまき起こった。	割れんばかりの<br>割れないばかりの<br>割れたばかりの<br>割れようばかりの
去年までは学生の好きなところに就職できた。今年は一転して不景気で就職難だ。人の運命は、努力や才能に{{c1::反して}}、生まれるのが一年はやいか遅いかで決まることもあるのだ。	反して<br>かかわらず<br>したがって<br>即して
遊園地の乗り物はどんなに恐ろしくても、安全性は計算しつくされている。{{c1::それにひきかえ}}大自然はおだやかに見えても、大きな危険性が常に隠されている。	それにひきかえ<br>それにもまして<br>いかんにかかわらず<br>その半面
彼は子ども時代のつらい経験を、涙{{c1::ながらに}}語った。	ながらに<br>ばかりに<br>ともに<br>がてらに
今はさわやかな毎日だが、6月とも{{c1::なれば}}雨の日が続く。	なれば<br>すると<br>いえば<br>なって
もともとがんこな人だったが、年を取ると以前にも{{c1::まして}}がんこになった。	まして<br>さらに<br>ますます<br>いっそう
病気だったのなら、お見舞いに行ってあげた{{c1::ものを}}。どうして電話してくれなったの。	ものを<br>ところを<br>はずを<br>ことを
その客はスカートを10着も試着した{{c1::あげく}}、1着も買わないで帰った。	あげく<br>どころか<br>かぎり<br>が最後
あんなことをいわれて、あなた{{c1::にすれば}}、さぞくやしいでしょうね。	にすれば<br>といえば<br>にきては<br>となると
平和なれば{{c1::こそ}}、将来の夢を語ることができる。	こそ<br>ゆえに<br>から<br>さえ
いまさらどんなに後悔した{{c1::ところで}}、取り返しはつかないだろう。	ところで<br>どころか<br>ものが<br>ものでも
暑かった去年の夏に{{c1::ひきかえ}}、今年の夏は寒いくらいだ。	ひきかえ<br>反対に<br>逆に<br>おきかえ
もう年だなあ！　勉強しても覚える{{c1::そばから}}忘れてしまうよ。	そばから<br>途中から<br>あとから<br>一から
わずか８歳{{c1::にして}}、その少年はチェスのプロである父親を負かした。	にして<br>になって<br>として<br>としては
彼女は、息子が婚約すると、本人{{c1::はもとより}}家族や親戚のことまで調べた。	はもとより<br>をはじめて<br>ならずも<br>といわないまでも
一人息子が家を{{c1::出て}}からというもの、母親はいきる力を失ったようだ。	出て<br>出た<br>出る<br>出よう
軍隊のような規則{{c1::ずくめ}}の生活は、もうまっぴらだ。	ずくめ<br>まみれ<br>だらけ<br>ばかり
私の青春は戦争でつぶされた。今の平和が続くことを願って{{c1::やまない}}。	やまない<br>おわらない<br>きりない<br>かぎりない
教師{{c1::たる}}もの、学生を叱るよりまず自分自身が勉強しなければ。	たる<br>なる<br>ある<br>さる
「勉強が好きだ」と{{c1::いえば}}うそになるが、全然しないわけではない。	いえば<br>すれば<br>なれば<br>いうなら
「ゼロを一つ間違えたんじゃないか」「漢字で一千万円と書いてあるんだ。間違え{{c1::ようがない}}よ」	ようがない<br>はずがない<br>わけがない<br>かねない
この小説は事実に{{c1::もとづいて}}かかれただけあって、迫力がある。	もとづいて<br>際して<br>よって<br>反して
社長は社員に給料を払わない{{c1::ばかりか}}、そのことに対する説明もしない。	ばかりか<br>に限らず<br>ものの<br>とはいえ
日本人はとかく、うわさをすぐ信用{{c1::しがち}}だ。冷静に真実を確かめるようにしなければ。	しがち<br>するべき<br>すまじき<br>しかねない
「えっ、それを一人で全部食べてしまったの」「だって、昨日から何も食べていないんです{{c1::もの}}」	もの<br>ので<br>こと<br>ゆえ
今年は戦後ちょうと５０年目の{{c1::こととて}}、各地で記念行事が行われた。	こととて<br>だから<br>わけで<br>だけあって
梅雨が明けた。これからはだんだん暑くなる{{c1::一方}}だ。	一方<br>ところ<br>だけ<br>以上
ちょっと気分が悪いのです。{{c1::帰らせて}}いただいていいでしょうか。	帰らせて<br>帰られて<br>お帰り<br>お帰りになって
アメリカ人といっても、皆が必ずしも英語を話す{{c1::わけではない}}。	わけではない<br>はずがない<br>わけがない<br>にきまっている
現在、この病気が治せるのはあの医者をおいて{{c1::ほかにはいない}}。	ほかにはいない<br>ほかにもいる<br>ほかにいるかもしれない<br>ほかにいなくもない
ひどい奥さんと別れた友人は「結婚なんて{{c1::するものではない}}」と、いつも私に忠告する。	するものではない<br>するわけがない<br>しないものでもない<br>するどころではない
最近は交通事故はニュースにもならないが、毎年１万人も死んでいるということは深刻な事態だと{{c1::いわざるをえない}}。	いわざるをえない<br>いわないだろう<br>いわないものでもない<br>いうわけにはいかない
あの女優は、顔はたしかにきれいだけど、縁起は小学生なみで{{c1::見るにたえない}}。	見るにたえない<br>見てはいけない<br>見ることができない<br>見ないものでもない
日本の女性の大学進学率は、世界でも一、二を争うほどだ。{{c1::にもかかわらず}}、社会で活躍する女性の割合は、先進国中、最低に近いのはどうしたことだろう。	にもかかわらず<br>それにもまして<br>それに関して<br>そうしたところで
人の体の欠点を笑い物にするのは、ユーモアとは呼べないはずだ。しかしテレビでは、そのような番組ばかりやっている。障害者をからかうに{{c1::至っては}}、怒りを禁じ得ない。	至っては<br>おいては<br>もまして<br>ついて
一口に犬といってもいろいろな種類がいる。しかし、どんな種類の犬{{c1::であれ}}、人間のもっとも良い友達であることに違いはない。	であれ<br>とはいえ<br>いかんで<br>といい
その日も夫は妻に文句を言い続けた。いつもおとなしい彼女の{{c1::ことだから}}、だまって聞き流すと思いきや、突然「それなら別れましょう」ときっぱりと言った。	ことだから<br>だけあって<br>ものだから<br>はずで
海外に出張した折、劇を見に連れて行ってもらった。みんなゲラゲラ笑っているのだが、外国語のわからない私にはおもしろさが{{c1::わかるはずもなく}}、一人でだまっていた。	わかるはずもなく<br>わからんがため<br>わからないながらに<br>わかるまでもなく
さあ、食事を始めようという{{c1::ところ}}に、電話がかかってきた。	ところ<br>とたん<br>もの<br>こと
そんなことをして、父親{{c1::として}}子どもに恥ずかしくないの？	として<br>とはいえ<br>だから<br>ならば
最新の医学を{{c1::もって}}しても、彼女の病気を救うことはできなかった。	もって<br>とって<br>つかって<br>よって
あの二人は仲のいい夫婦だと{{c1::思いきや}}、突然離婚してまわりを驚かせた。	思いきや<br>思えば<br>思いつつ<br>思ったり
お土産を買ってきました。明日ごあいさつ{{c1::かたがた}}、お宅にお持ちします。	かたがた<br>一方で<br>かたわら<br>しながら
社長{{c1::あっての}}わが社です。どうかご自愛ください。	あっての<br>にとって<br>によれば<br>であれば
Ａさんは信頼するに{{c1::足}}人です。安心してまかせてなさい。	足<br>できる<br>あたる<br>なる
水不足が深刻です。水を出し{{c1::っぱなし}}で歯を磨くのはやめましょう。	っぱなし<br>ながら<br>っきり<br>つつ
吹く風に暖かさが感じられ、だんだん春{{c1::めいて}}きた。	めいて<br>じみて<br>っぽく<br>らしく
この仕事は技術もいるし、責任も重い。その{{c1::わりに}}報酬が少ない。	わりに<br>ために<br>せいで<br>おかげで
ごめんなさい。疲れていた{{c1::ものだから}}、約束をすっかり忘れて寝てしまいまったの。	ものだから<br>わけだから<br>ことだから<br>からとて
彼は毎日、５時になる{{c1::が早いか}}、会社を飛び出していく。	が早いか<br>かないかのうちに<br>とたんに<br>そばから
となりの息子は働きながら、大学を一番で卒業したそうだ。それに{{c1::ひきかえ}}うちの息子は、親の金で遊んでばかりいる。	ひきかえ<br>しては<br>したって<br>ひきかえに
宝くじを買ったら、１番の違いで３千万円をのがしてしまった。くやしい{{c1::ったら}}ありゃしない。	ったら<br>のは<br>ければ<br>なら
そんな命令を出す社長も社長{{c1::なら}}、それに従う社員も社員だね。	なら<br>だから<br>といえば<br>だったら
新しい法案を{{c1::めぐって}}、与党と野党が激しく論議している。	めぐって<br>対して<br>ついて<br>関して
彼は子どものとき中国で育った{{c1::だけに}}、中国語の発音が良い。	だけに<br>ばかりに<br>ながら<br>からには
新しい市長は、議員の批判を{{c1::ものとも}}せずに、改革を進めていった。	ものとも<br>ものを<br>ものにも<br>ものに
戦後、父は{{c1::生きんが}}ために、あらゆる仕事に手を出した。	生きんが<br>生きよう<br>生きたい<br>生きた
幼い子どもをゆうかいして殺すなんて、許し{{c1::がたい}}ことだ。	がたい<br>まじき<br>にくい<br>かねない
このメロンはちょっと高いけど、味{{c1::といい、といい}}かおり{{c1::といい、といい}}最高だよ。	といい、といい<br>なり、なり<br>から、まで<br>であれ、であれ
アルプスの夕日のすばらしさと{{c1::いったら}}とても口では言い表せないよ。	いったら<br>なれば<br>いえば<br>したら
おいしそうなお菓子ですね。えんりょなく{{c1::ちょうだい}}いたします。	ちょうだい<br>おあがり<br>ごちそう<br>いただき
彼の両親はプロゴルファーなんだ。彼がゴルフが上手でも驚くに{{c1::あたらない}}よ。	あたらない<br>あたいしない<br>おどろかない<br>かたくない
あの男のせいで私の人生はめちゃくちゃになった。もし、彼が無罪になったら、私自身で仕返しせずには{{c1::いけない}}。	いけない<br>やまない<br>おかない<br>ゆるさない
人前で、あんなに自分の妻の悪口を、よく{{c1::言えたものだ}}。	言えたものだ<br>言うものか<br>言わなかった<br>言ったものだった
私がさんざん待たせたにもかかわらず、彼は{{c1::いやな顔もしないで待っていた}}。	いやな顔もしないで待っていた<br>待たずに帰ってしまった<br>ひどく怒ってしまった<br>待たないではいられなかった
きのう、おもしろい物をもらったんですよ。先生にもごらんに{{c1::いれましょうか}}。	いれましょうか<br>なりますか<br>いたしましょうか<br>差し上げましょうか
今までの日本の会社は一般的に、年を{{c1::取るにしたがって}}出世していった。だが技術革新によって、若い人の方がすぐれた技術を持つ場合も多くなり、この制度もくずれ初めている。	取るにしたがって<br>取ることによって<br>取ろうが取るまいが<br>取ったがために
彼女は、若いときはなかなか才能が認められなかったが、その美ぼうが人一倍の努力{{c1::と相まって}}今や日本の代表する大女優となった。	と相まって<br>といっしょに<br>とひきかえに<br>とあって
大学に入って勉強している人が、高卒で働いている人を見下すことがあるが、それは大きな過ちだ。学生はそういう人たちに勉強{{c1::させていただいている}}のだ。大学を支えているのは、働いている人たちの税金なのだから。	させていただいている<br>していただいている<br>させられている<br>させてくださった
中高年の人の間で山登りがはやっている。それはいいことだが、どんな低い山でも天候や本人の健康状態のいかんに{{c1::よっては}}、危険な事故を起こしかねないので注意が必要だ。	よっては<br>よらず<br>かかわらず<br>では
そのレストランの主人は「物好きだ」と言われ{{c1::つつも}}、毎月一回貧しい人たちのために、ただでカレーをふるまっている。	つつも<br>ながらに<br>んがため<br>んばかりに
もう一日早く病院に行っていたら、命は助かった{{c1::ものを}}。	ものを<br>ことに<br>ものの<br>ことを
今時の若いもの{{c1::ときたら}}、老人に席をゆずろうともしない。	ときたら<br>としたら<br>だったら<br>といっても
私がどんなに努力した{{c1::ところで}}、彼にはかなわないよ。	ところで<br>わりに<br>までも<br>ものを
新しい地震情報が入り{{c1::次第}}、臨時ニュースをお送りします。	次第<br>とたんに<br>やいなや<br>が早いか
この映画は以前見た{{c1::とはいえ}}、だいぶ昔のことなので内容はほとんど覚えていない。	とはいえ<br>のだから<br>からには<br>として
この薬を飲み{{c1::始めて}}からというもの、どうも胃の調子がおかしい。	始めて<br>初めて<br>始める<br>初め
晴れたか{{c1::と思いきや}}、もう雨が降り出す。梅雨の天気は変わりやすい。	と思いきや<br>うちに<br>晴れないかと<br>早いか
これが国民を代表する政治家の姿{{c1::とは}}、あまりにも情けない。	とは<br>にも<br>だに<br>かと
暑い{{c1::につけ、につけ}}寒い{{c1::につけ、につけ}}、娘は親の健康を気づかった。	につけ、につけ<br>といい、といい<br>も、も<br>なり、なり
特急にご乗車に{{c1::際して}}は、乗車券の他に特急券が必要です。	際して<br>して<br>よって<br>とって
ちょうどお風呂に入り{{c1::かけた}}時、電話のベルが鳴った。	かけた<br>つつある<br>そうな<br>ながらの
息子がこんなことをするなんて、くやしい{{c1::やら、やら}}情けない{{c1::やら、やら}}。	やら、やら<br>なり、なり<br>といい、といい<br>ったり、ったり
日本人の奥さんをもらって、中国の料理を食べて、アメリカの家に住む。これが男の幸せの{{c1::極み}}だといわれたことがある。	極み<br>最大<br>最高<br>至り
Ａさんは看護婦だった{{c1::だけあって}}、けが人のそばにかけよるとてきぱきと手当を始めた。	だけあって<br>だからこそ<br>といえども<br>ならでは
観光客が帰った後の行楽地は、いつもゴミと空き缶{{c1::だらけ}}だ。	だらけ<br>まみれ<br>ずくめ<br>だけ
「うちの子に{{c1::限って}}そんなことするはずない」と、どの親も言う。	限って<br>だけは<br>とって<br>対して
現代は電気なしの生活は一日も考えられない。停電でも{{c1::しよう}}ものなら、たちまち大混乱が起きる。	しよう<br>しそう<br>する<br>した
社長がこの事件の責任を取って辞職したので、社長側についていた重役も退職を{{c1::余儀}}なくされた。	余儀<br>仕方<br>無理<br>可否
わが子に死なれた母は、気も狂わん{{c1::ばかりに}}泣き叫んだ。	ばかりに<br>ように<br>がために<br>ほど
貧しさ{{c1::ゆえに}}多くの苦しみを味わった彼は、必死に金をもうけ資産家となった。	ゆえに<br>だけに<br>ばかりに<br>となれば
プロの歌手{{c1::ともなると}}、のどに悪いといって真夏でも冷たい物を飲まない人もいる。	ともなると<br>ならでは<br>ゆえに<br>なればこそ
寝不足が続いて、ここのところ疲れ{{c1::気味}}だ。	気味<br>るはず<br>るもの<br>げ
とにかく本人から事情を聞かない{{c1::ことには}}、私にも何もわからない。	ことには<br>ものには<br>までは<br>わけで
タバコは１本でも有害ですが、お酒は飲みすぎ{{c1::さえ}}しなければ、それほど害にはなりません。	さえ<br>だけ<br>のみ<br>こそ
パーティーには、首相{{c1::をはじめ}}、政治家や実業家がずらりと出席した。	をはじめ<br>と問わず<br>をめぐり<br>をもとに
いくら名誉や富があっても、死んでしまえば{{c1::それまでだ}}。	それまでだ<br>それからだ<br>それだけだ<br>それほどでもない
こんなに教育費が高いと、若い夫婦は子どもを持とうにも{{c1::持てない}}。	持てない<br>持ちかねない<br>持たない<br>持とうとしない
「あれほど優秀だった彼のことだ。きっと偉くなったにちがいない」と思いきや、{{c1::食うや食わずの生活をしていた}}。	食うや食わずの生活をしていた<br>本当に優秀だった<br>はたして社長になっていた<br>やはり幸せに暮らしていた
あの男は金をもうけるためなら、人殺しだって{{c1::やりかねない}}。	やりかねない<br>やるにあたらない<br>やりかねる<br>やるにかたくない
これはあなたの仕事だが、どうしても一人では間に合わないというなら{{c1::手伝わないでもない}}。	手伝わないでもない<br>手伝うはずがない<br>手伝うにはあたらない<br>手伝うわけにはいかない
私はタバコは吸わないが、新幹線では子供の少ない喫煙車に乗ることにしている。タバコの煙が有害{{c1::といえども}}、ギャーギャー騒ぐ子供と、それに注意さえしない親を見ているよりは心の健康によいからだ。	といえども<br>のみならず<br>のこととて<br>だからこそ
受験料を払った方には領収書を差し上げます。その領収書{{c1::として}}受験票としますから、試験当日には忘れずに持ってきてください。	として<br>にとって<br>をもって<br>によって
たとえ５０歳を過ぎて人の上に立つような地位の人でも、自分の感情のままに怒ったりわがままを言うような大人{{c1::げない}}人って、どこにでもいるものです。	げない<br>らしい<br>じみた<br>っぽい
外国語を学ぶときは、まずたくさん聞いてみることだ。最初はわかろうと{{c1::わかるまいと}}気にすることはない。そのうち、体で覚えてくるものだ。	わかるまいと<br>わからないが<br>わかるまいが<br>わからなければ
「知りませんでした」と言えば、言い訳になると思っているのかい。それは甘え{{c1::というもの}}だ。プロにとって、知らないということは無能ということだよ。	というもの<br>とするもの<br>としたもの<br>というところ
大学に入った{{c1::ものの}}、毎日遊んで暮らしている。	ものの<br>ことに<br>ことが<br>ものを
彼女は客が帰る{{c1::やいなや}}、掃除を始めた。	やいなや<br>とたんに<br>すぐに<br>しだい
あの地震のすさまじさと{{c1::いったら}}、思い出しただけでも震えてくる。	いったら<br>いうなら<br>いわば<br>いえば
今日は敬老の日ですから、６０歳以上の方に{{c1::かぎり}}、入場無料です。	かぎり<br>のみならず<br>だけ<br>おいて
国際結婚をする{{c1::からには}}、奥さんの国の習慣も尊重しなければいけないよ。	からには<br>とはいえ<br>ためには<br>こととて
二人のランナーはずっと抜きつ{{c1::抜かれつ}}していたが、４０キロ地点を越えてからＡ選手の独走になった。	抜かれつ<br>抜かれず<br>抜いたり<br>抜きつつ
汚職をした政治家がまた当選してしまった。政治家{{c1::も、も}}政治家なら、それを選ぶ国民{{c1::も、も}}国民だね。	も、も<br>が、が<br>が、は<br>は、は
だめよ、そこに入っては。ここに「芝生に入る{{c1::べからず}}」って書いてあるでしょう。	べからず<br>べし<br>禁ずる<br>得ない
考え{{c1::得る}}限りの方法を考えてみたのだが。やはりあきらめるしかないだろうね。	得る<br>かねない<br>かねる<br>得ない
今日の試合で優勝が決まる{{c1::とあって}}、サッカー場の外には朝から人が並んだ。	とあって<br>といっても<br>となれば<br>とくると
飛行機は明朝８時に飛ぶ予定ですが、天候に{{c1::よっては}}遅れることがあります。	よっては<br>かかわらず<br>よらず<br>では
この本は返してくれなくてもいいですよ。人にあげる{{c1::なり}}何なり、好きにしてください。	なり<br>のも<br>とか<br>ほか
物語の内容{{c1::からして}}、この本はお子さんには少し難しいと思いますよ。こちらの漢字の少ない本はいかがですか。	からして<br>とすれば<br>によると<br>になると
父は外国に行く{{c1::たびに}}、めずらしいおみやげを買ってきてくれる。	たびに<br>ところ<br>時は<br>やいなや
この成績ではねえ。今からいくらがんばった{{c1::ところで}}、卒業することは難しいと思うよ。	ところで<br>どころか<br>とすれば<br>にしては
この輝きは、ダイヤモンド{{c1::ならでは}}のものですね。	ならでは<br>だから<br>からこそ<br>だったら
お別れして以来、あなたのことを一瞬{{c1::たりとも}}忘れたことはありません。	たりとも<br>なりも<br>からして<br>といっても
まさか！　あの正直な彼がうそを{{c1::つきっこ}}ないですよ。	つきっこ<br>つき<br>つかず<br>つきつつ
自分が子どもを持って{{c1::からというもの}}、親のありがたさがしみじみわかるようになった。	からというもの<br>おいて<br>みれば<br>はじめに
とにかく事実を{{c1::確かめない}}ことには。うわさだけで心配していても始まらない。	確かめない<br>確かめる<br>確かめよう<br>確かめた
消費税の値上げに{{c1::ともなって}}、物価もまた上がるだろう。	ともなって<br>ついて<br>そって<br>おいて
色々と迷った{{c1::末に}}、就職しないで留学することを決意した。	末に<br>反面<br>ところ<br>が最後
貧しい生活の中で私は大学に行く{{c1::どころではなく}}、親の仕事を手伝っていた。	どころではなく<br>ばかりか<br>か行くまいか<br>までもなく
世界中の数学者{{c1::ですら}}解けなかった問題だよ。どうして君なんかに解けるものか。	ですら<br>だからこそ<br>にせよ<br>こそ
イギリスの文学は、シェイクスピアぬきには{{c1::語りえない}}。	語りえない<br>語らない<br>語ったことがない<br>語りかねない
医者にしたって、必ずしも自分の健康に気をつけている{{c1::とはかぎらない}}。	とはかぎらない<br>はずがない<br>わけがない<br>といえなくもない
あのレストランの料理ときたら、値段が高いばかりで{{c1::すすめられたものではない}}。	すすめられたものではない<br>すすめたことがない<br>ぜひすすめてみるべきだ<br>すすめないでいられない
あなたの命を救ったのは、御主人であるあなたを必死に守ったこの犬に{{c1::ほかならない}}。	ほかならない<br>ほかはない<br>ほかにはない<br>ほかしかたない
彼女を心から愛していたんだ。あきらめろと言われたって{{c1::あきらめきれない}}よ。	あきらめきれない<br>あきらめられる<br>あきらめかねない<br>あきらめざるを得ない
日本で旅行すると、ちょっと乗り物に乗っても、旅館に泊まっても、一万円札がすぐ飛んでいく。{{c1::それにひきかえ}}、外国では何と一万円が使いでがあることだろう。	それにひきかえ<br>ふりかえって<br>それと同様に<br>それにつけても
これほどの作品を作り上げるには、どれほどの苦労があったことか想像にかたくない。しかし彼はインタビューに対して{{c1::こともなげ}}、「大したことありませんよ」と答えた。	こともなげ<br>ことにもせず<br>ものともせず<br>おそれもなし
会社の面接試験では、親の財産や職業のように本人にはどうしようもないことや、プライバシーに関することは、規約によって聞いてはいけない{{c1::ことになっている}}。しかし、この規約はしばしば破られているようだ。	ことになっている<br>わけでもない<br>ものでもない<br>にほかならない
技術が進歩すれば、世の中はますます便利になる{{c1::に相違ない}}。その反面、ある人が一生にかけて習得した技術が無用のものになり、人間が使い捨てられている現実もある。	に相違ない<br>といえたものだ<br>にはあたらない<br>というところだ
世界では何億という人が、食べるものがなくて死にかけているのよ。おいしかろうが、{{c1::まずかろうが}}、おなかいっぱい食べられるだけで感謝しなければいけないわ。	まずかろうが<br>おいしくまいと<br>おいしくあろうが<br>まずくなかろうが
いったん約束をした{{c1::以上}}、つらくても守らなくてはいけないよ。	以上<br>ものの<br>とはいえ<br>だけあって
３年間、厳しい練習に耐えたんだ。明日の試合、負けてなる{{c1::ものか}}！	ものか<br>ことか<br>ことを<br>ものを
あの人は一度も日本に来たことがないのに{{c1::しては}}、きれいな日本語を話すね。	しては<br>しても<br>なっても<br>よらず
あの悲しいできごとを{{c1::忘れよう}}にも忘れられません。	忘れよう<br>忘れる<br>忘れた<br>忘れたい
高校生になっても、そんな子ども{{c1::っぽい}}いたずらをするんじゃない。	っぽい<br>めいた<br>らしい<br>ような
日本人の平均寿命が８０歳を越え、子どもの減少と{{c1::相まって}}、高齢化が急速に進んでいる。	相まって<br>かかわらず<br>したがって<br>いうのは
試験当日は理由の{{c1::いかんによらず}}、遅刻は認めませんから注意してください。	いかんによらず<br>いかんによっては<br>いかんで<br>いかんでも
赤ちゃんの服は、気温に{{c1::応じて}}、時々調整してください。	応じて<br>ついて<br>関して<br>対して
「女の{{c1::くせに}}たばこを吸うな」なんて言われたら、かえって吸いたくなる。	くせに<br>せいで<br>ためには<br>ゆえに
あなたのお母様は、いつこちらに{{c1::お見えに}}になるんですか。	お見えに<br>おうかがい<br>拝見<br>おじゃま
日本の料理に、みそ・しょうゆは欠く{{c1::べからざる}}ものだ。	べからざる<br>べき<br>ほかにはない<br>得ない
個人のプライバシーに{{c1::関する}}情報は、守らなければならない。	関する<br>つけて<br>よる<br>即した
生徒をなぐって大けがをさせるなんて、教師にある{{c1::まじき}}行為だ。	まじき<br>えない<br>べき<br>ざる
楽で、給料が高くて、労働時間が短いなんて、そんないいこと{{c1::ずくめ}}の仕事なんてありませんよ。	ずくめ<br>まみれ<br>ばかりに<br>しか
そのランナーは、足のけがを{{c1::ものとも}}せずに、ゴールに向かって走り続けた。	ものとも<br>ものには<br>こととも<br>ことにも
うちの娘は親の心配を{{c1::よそに}}、いっこうに結婚しようともしない。	よそに<br>そとに<br>ほかに<br>うらに
よほど疲れていたのだろう。横になるか{{c1::ならないか}}のうちに、もう眠っていた。	ならないか<br>なったか<br>なってか<br>ないか
こちらに来る{{c1::ついで}}がありましたので、お借りした本を返しにまいりました。	ついで<br>かたわら<br>つごう<br>がてら
あの男は頭はいいのだが、すぐなまけたがるきらい{{c1::があります}}。	があります<br>です<br>になります<br>にします
その肖像画は、まるで生きている{{c1::かの}}ように見えた。	かの<br>とかの<br>というもの<br>みたいな
社長のお宅に{{c1::うかがった}}おりに、ゴルフクラブをいただきました。	うかがった<br>行かれた<br>まいられた<br>いらっしゃった
私の家は、貧しい{{c1::ながらも}}いつも笑い声が絶えなかった。	ながらも<br>ゆえに<br>からこそ<br>までも
原則として禁止ですが、理由の{{c1::いかんによっては}}、特別に例外を認めましょう。	いかんによっては<br>いかんによらず<br>次第で<br>次第によって
あの人は多才で、絵もかけ{{c1::ば}}、ピアノもひく。しかもプロ並みだ。	ば<br>ると<br>たら<br>るも
３時間も待たされた{{c1::あげく}}、「ここは専門ではありません。他の科に行ってください」だって！	あげく<br>結果<br>とたんに<br>かいなかで
まさか、あの人に限ってそんなことを{{c1::するはずがない}}。	するはずがない<br>しかねない<br>するかもしれない<br>せずにはいられない
あなたの多くの人名を救った勇敢な行為は、いくらほめても{{c1::ほめ足りません}}。	ほめ足りません<br>ほめられません<br>ほめざるをえません<br>しかたがありません
彼女は私と婚約していたのに、突然ほかの男と結婚してしまった。これが裏切り{{c1::でなくてなんだろう}}。	でなくてなんだろう<br>ではないだろう<br>とはいえないだろう<br>にはあたらないだろう
私は子どもの病気について知ろうと、難しい医学書を１週間で{{c1::読みきった}}。	読みきった<br>読み終えた<br>よみつくした<br>読みとおした
ただ安いからといって、すぐ飛び付いていたら{{c1::損にも得にもならない}}。	損にも得にもならない<br>必ずしも損ではない<br>かなり得になるだろう<br>かえって損をしがちだ
知らずにやったこと{{c1::とはいえ}}、悪いことをしたのは確かなのだ。謝罪せずにはすまないだろう。	とはいえ<br>なのだから<br>ですら<br>とあって
蒸し暑い日本の夏に、涼しいヨーロッパの人と同じ背広を着たあげく、冷房をこんなに強くするなんて。女子社員に{{c1::至っては}}寒さで震えている。	至っては<br>しては<br>ついては<br>おいては
以前は顔がかわいいだけの歌手が、聞くに{{c1::たえない}}歌を歌っていたものだ。近ごろは聞く人の耳が肥えたのだろう。そんな歌手は減ってきた。	たえない<br>およばない<br>聞けない<br>たりない
来月はいよいよ国へ帰ることとなった。おととしの春からだから、足かけ３年に{{c1::わたる}}留学生活だった。色々な思い出がよみがえる。	わたる<br>かけて<br>とどく<br>過ぎる
仕事にもきちんと就いたし、小さいながらも家も建てた。あとはおよめさんをもらう{{c1::ばかり}}になっているのに、女の人と知り合うチャンスがなかなかない。	ばかり<br>きり<br>のみ<br>こと
「若い時もっと勉強すればよかった」と、どんなに後悔した{{c1::ことか}}！	ことか<br>ものか<br>ものを<br>ことを
結婚しているかって？　忙しくって結婚は{{c1::おろか}}、恋人だって見つけるひまがありませんよ。	おろか<br>もともと<br>わずか<br>しても
仕事が速くて正確なことに{{c1::かけては}}、わが社で彼の右に出るものはいません。	かけては<br>めぐって<br>対して<br>とっては
ここ３か月、雨も{{c1::降らなければ}}、雪も降らない。このままでは水不足が心配だ。	降らなければ<br>降らないので<br>降らないと<br>降らなくても
私の医者としての経験から{{c1::すると}}、こういう患者は治りにくい。	すると<br>感じると<br>といい<br>やると
天才的なＡさんには及ばない{{c1::までも}}、Ｂさんだってかなりの腕前だ。	までも<br>かぎり<br>ので<br>どころか
町を歩いていると、どこ{{c1::からともなく}}パンの焼けるいい匂いがしてきた。	からともなく<br>でもなく<br>までからか<br>からでなく
君では{{c1::あるまい}}し。ぼくは財布を忘れるなんて馬鹿なことはしないよ。	あるまい<br>あろう<br>なかろう<br>あった
年の{{c1::わりには}}体力があるといえますが、あまり無理をしないようにしてください。	わりには<br>かぎり<br>上では<br>くせして
彼女は仲間に対して、まるで女王の{{c1::ごとく}}わがままを通した。	ごとく<br>らしく<br>ふうに<br>ままに
いま電話があって、田中さん、１時間遅れて来る{{c1::との}}ことです。	との<br>かの<br>とか<br>そう
あなたの日ごろの実力を{{c1::もって}}すれば、試験なんて大丈夫、合格しますよ。	もって<br>とって<br>よって<br>かけて
この不況では昇給なんてのぞむ{{c1::べく}}もない。倒産しないだけましだよ。	べく<br>わけ<br>こそ<br>よう
お手伝いさんをやとっている{{c1::にしろ}}、自分の下着くらい自分で洗いなさい。	にしろ<br>ものを<br>けれども<br>ところで
彼の字は汚い。書いた本人{{c1::からして}}、読めないほどだ。	からして<br>からこそ<br>どころか<br>ところで
鈴木さんは夕食を食べさせてくれた{{c1::ばかりか}}、おみやげにもたくさん食べ物を持たせてくれた。	ばかりか<br>ばかり<br>ばかりで<br>ばかりに
この機械を扱うに{{c1::際して}}は、細心の注意が必要です。	際して<br>とって<br>至って<br>かけて
給料は、基本給の他に、能力に{{c1::応じて}}いくらかプラスされます。	応じて<br>めぐって<br>関して<br>つき
どうですか、この住宅は。広さ{{c1::といい、といい}}環境{{c1::といい、といい}}、これ以上のものはありませんよ。	といい、といい<br>につけ、につけ<br>であれ、であれ<br>も、ならば
「この原子力発電所がもし事故を起こしたら」なんて、想像する{{c1::だに}}恐ろしい。	だに<br>だけ<br>でも<br>さえ
被災者の家族は、不安{{c1::げな}}顔で、テレビのニュースを見つめていた。	げな<br>のような<br>らしい<br>じみた
過ぎたことを後悔しても始まりません。ただ前進ある{{c1::のみ}}です。	のみ<br>しか<br>こそ<br>だけ
私の命に{{c1::かけても}}、乗客の安全は守り抜きます。	かけても<br>関しても<br>しても<br>とっても
タバコはやめようと思い{{c1::つつ}}、つい手が出てしまう。	つつ<br>ものの<br>そばから<br>けれど
いつまでもお若くて{{c1::いらっしゃい}}ますね。若さの秘訣は何ですか。	いらっしゃい<br>おられ<br>ござい<br>あり
今さらどんなにくやしがったところで、取られたお金が{{c1::戻るわけではない}}。	戻るわけではない<br>戻らずにはすまない<br>戻ってくるかもしれない<br>戻らざるをえない
山の天気も荒れてきたし、みんなも疲れている。残念だが引き返すより{{c1::ほかはない}}。	ほかはない<br>ほかならない<br>にあたらない<br>に相違ない
才能とは生まれつきのもので、自分で努力してもどうにもならないところがある。ましてや、{{c1::努力もしないで言い訳をしてはならない}}。	努力もしないで言い訳をしてはならない<br>努力次第ではなんとかなるかもしれない<br>他人がとやかくいってもしかたがない<br>他人の助けがあれば伸びることもある
「常に子どもには優しくあれ」と言われても、母親だって神様ではあるまいし、ときには{{c1::怒らずにはいられない}}。	怒らずにはいられない<br>悔しいはずがない<br>優しくなれなくもない<br>厳しいとしかいいようがない
寝坊してしまって、約束の時間まで後１０分しかなかった。タクシーを急がせたけれども{{c1::間に合いようがなかった}}。	間に合いようがなかった<br>遅刻せずにはおかなかった<br>遅刻はまぬがれた<br>間に合わないところだった
子どもが減っているので、受験戦争も緩和されるだろうと思いきや、親は「一人か二人しかいない子ども{{c1::だからこそ}}いい学校に入れたい」と、ますます熱を上げ始めた。	だからこそ<br>といえども<br>次第では<br>こととて
インターネットのおかげで、障害があって家から出られない人が、家に{{c1::いながらにして}}、世界中の情報に接することができるようになった。	いながらにして<br>いるに関わらず<br>いようといまいと<br>いると同時に
子どもたちが、はなやかで現代的な仕事にばかりあこがれる{{c1::とすれば}}、それは社会の目立たないところでコツコツと働いている人の存在を我々大人が忘れているからではないだろうか。	とすれば<br>とにかく<br>ともなく<br>ともあれ
勉強は、がんばればがんばるほど成果が速く出ることが多い。しかし生き物を育てる仕事は、がんばったからといって成果が早く{{c1::出るとはかぎらない}}。何もしないでじっと待っているのが一番、ということもある。	出るとはかぎらない<br>出ないはずがない<br>出るわけがない<br>出るはずがない
彼女は長い間、考え抜いて離婚を決意したのだ。今さら、夫が何を{{c1::言ったところで}}、彼女の気持ちが変わることはないだろう。	言ったところで<br>言うまいと<br>言うによっては<br>言ったとあって
病気が治って、以前にも{{c1::まして}}お元気そうに見えますね。	まして<br>よりも<br>ふえて<br>もっと
彼には、人とは違うが、彼{{c1::なり}}の生き方の信念があるのだ。	なり<br>のみ<br>より<br>こそ
元オリンピック選手{{c1::だけ}}あって、今でも走ると若者よりも速い。	だけ<br>こそ<br>だと<br>ので
こんないたずらをするのは、あの人の悪い田中さんに{{c1::きまって}}いる。	きまって<br>わかって<br>知れて<br>ちがわずに
彼はその日の気分に{{c1::よって}}、言うことがころころ変わる。	よって<br>関して<br>即して<br>ついて
1番になれとは{{c1::言わないまでも}}、せめて人並みの成績を取ってくれ。	言わないまでも<br>言ったまでで<br>関して<br>言うけれど
いじめによる自殺者が出るに{{c1::至って}}、ようやく学校側は調査を始めた。	至って<br>あたって<br>関して<br>たっして
親友のあなたの頼み{{c1::といえども}}、人をだますようなことはできないわ。	といえども<br>とあれば<br>をもって<br>にしては
彼は本を読み始めたが{{c1::最後}}、まわりのことは何も目に入らなくなる。	最後<br>とたん<br>そばから<br>早いか
人間は他の生き物の命をうばう{{c1::ことなしに}}、生きてはいけない。	ことなしに<br>ないでは<br>ところで<br>ものの
試験に失敗したら、またやり直す{{c1::まで}}のことです。心配しないでください。	まで<br>ため<br>なり<br>から
彼は自分が{{c1::助からん}}がために、親友を敵に売った。	助からん<br>助ける<br>助かろう<br>助からない
これはもうあなたのものです。煮る{{c1::なり、なり}}焼く{{c1::なり、なり}}、好きにしてください。	なり、なり<br>たり、たり<br>とか、とか<br>か、か
君たちの上達を願えば{{c1::こそ}}、きびしく教えているんだよ。	こそ<br>ゆえに<br>から<br>ために
そんなに上から下まで黒{{c1::ずくめ}}じゃ、まるでお葬式みたいよ。靴とバッグは赤にしたら？	ずくめ<br>のみ<br>だらけ<br>まみれ
多くの少女たちが、貧しさ{{c1::ゆえに}}教育を受けられないでいる。	ゆえに<br>ので<br>によって<br>ばかりに
若い人ばかり座っているのに、誰一人、お年寄りに席をゆずらない{{c1::ことか}}！	ことか<br>とは<br>ものを<br>ことを
真夏のマラソンとあって、選手たちは滝の{{c1::ごとく}}汗を流していた。	ごとく<br>みたいに<br>ばかりに<br>ほどに
失敗したらどうするかって？失敗したと{{c1::しても}}、またその時考えるまでさ。	しても<br>すると<br>しようと<br>もなると
真面目だったＡ君が、最近授業を休み{{c1::がち}}だ。どうしたのだろう。	がち<br>ばかり<br>気味<br>きり
学生時代、二人はうれしい{{c1::につけ、につけ}}悲しい{{c1::につけ、につけ}}いつも一緒だった。	につけ、につけ<br>やら、やら<br>なり、なり<br>といい、といい
大学を卒業した{{c1::以上}}、何とか一人で食べていかなくては。	以上<br>末<br>次第<br>始末
今、試験の{{c1::最中}}ですので、学生の呼び出しはできません。	最中<br>中途<br>間<br>真ん中
戦後最大の不況下{{c1::たりとも}}、少しでも無駄をはぶくことが要求されている。	たりとも<br>ながらも<br>にあって<br>であれ
軽い風邪です。ご心配には{{c1::およびません}}よ。	およびません<br>ありません<br>いたりません<br>いりません
誰もがお金を欲しがるが、あればあるほどいいと{{c1::いうものでもない}}。	いうものでもない<br>いうはずがない<br>いわないでもない<br>いうまでもないことだ
私の若い頃は食べるのがせいいっぱいで、趣味を楽しむ{{c1::どころではなかった}}。	どころではなかった<br>人がたくさんいた<br>ゆとりがあった<br>べきでなかった
あの新人歌手は、歌のうまさもさることながら{{c1::ダンスがまた素晴らしい}}。	ダンスがまた素晴らしい<br>ダンスは今一つだ<br>もっと練習したほうがいい<br>人気が出るかもしれない
あの旅館のサービスときたら！　二度と{{c1::行くものか}}。	行くものか<br>行かないでおかない<br>かないでもない<br>行こうにも行けない
先生は「絶対合格する」と言ってくれてはいるが、単なる気休めで{{c1::なくてなんであろう}}。	なくてなんであろう<br>はおかない<br>合格しなかった<br>合格しないではすまない
外国から果物を輸入するのではなく、この土地でとれるものだけを使って、ここ{{c1::ならでは}}のおいしいお酒を作ってみたいと思っている。	ならでは<br>限りでは<br>だから<br>のみならず
彼はいつもおだやかで親切な紳士である。ところがお酒を一滴でも飲んだ{{c1::が最後}}、手がつけられなくなる。	が最後<br>あげく<br>ばかりに<br>末に
工場の排水により、魚をとることもできなくなり、自分達も病気になった漁民たちは、ついにたまり{{c1::かねて}}、その工場をうったえた。	かねて<br>かねなくて<br>きれて<br>ざるを得なくて
祖父母から孫まで三世代が同居、女性が家庭で家事、育児をやるという生活様式は、次第に過去のものに{{c1::なりつつある}}。	なりつつある<br>なる一方だ<br>なるのみだ<br>なったわけではない
この絵は上手{{c1::とはいえないものの}}、彼なりにがんばって描いたものでしょう。その努力はみとめましょう。	とはいえないものの<br>の極みで<br>だろうが下手だろうが<br>といえども
その仕事はまだやり{{c1::かけ}}です。明日までやっておきます。	かけ<br>すぎ<br>中<br>きり
たとえ金がいくら{{c1::かかろう}}とも、手に入れずにはおかない。	かかろう<br>かかる<br>かかった<br>かけよう
僕たちより弱いチームに負けて、くやしいと{{c1::いったら}}なかった。	いったら<br>したら<br>きても<br>いえば
たばこは吸っている本人{{c1::のみ}}ならず、周りの人にも悪影響を及ぼす。	のみ<br>だけ<br>しか<br>ばかり
このままでは日本もアメリカ並の銃社会になる。早く{{c1::何とか}}しなければ。	何とか<br>何を<br>何だか<br>何も
何かを忘れていったとしても、お金{{c1::さえ}}あれば、向こうで買えますよ。	さえ<br>こそ<br>だに<br>すら
新年度の初日に{{c1::あたって}}、社長から一言ごあいさつをいただきます。	あたって<br>あって<br>よって<br>なって
その王の墓からは、王冠を{{c1::はじめに}}、数々の宝石や刀が発見された。	はじめに<br>はじめに<br>はじめて<br>はじめると
雨が降らない{{c1::うちに}}、早く家にお帰りなさい。	うちに<br>時に<br>間に<br>前に
年を取ると、昔のことは覚えていても、最近のことを忘れ{{c1::がちに}}なる。	がちに<br>にくく<br>がたく<br>えなく
この天気では、今日の運動会は中止{{c1::せざる}}を得ないね。	せざる<br>しない<br>しないわけ<br>する
彼の苦しさの{{c1::あまり}}、自殺すら考えた。	あまり<br>おかげで<br>くせで<br>そばから
彼女は何か{{c1::言いた}}げな顔をして、私のほうを見た。	言いた<br>言いそう<br>言って<br>言わな
「困ったときはいつでもいらっしゃい」という親切な言葉{{c1::のわりには}}、あの病院の応対は冷たいという評判だ。	のわりには<br>の際に<br>の末には<br>のもとで
時代の変化に{{c1::即した}}経済方針が、求められている。	即した<br>よった<br>関した<br>逆らった
お宅のお嬢さんが出ている映画を、もう{{c1::ごらんになり}}ましたか。とてもおきれいでしたよ。	ごらんになり<br>お見えになり<br>拝見され<br>あがり
国民の熱い期待に{{c1::こたえて}}、彼は堂々、金メダルを取った。	こたえて<br>応じて<br>反して<br>加えて
一人{{c1::きり}}で旅行に行ったが、はやりつまらなかった。	きり<br>のみ<br>しか<br>ほど
わざわざ手紙を書く{{c1::までもない}}が、時々電話をするように。	までもない<br>はずがない<br>わけもない<br>ところではない
飛行機の離陸に{{c1::際して}}のご注意を申しあげます。まずシートベルトをしめて、おタバコは消してください。	際して<br>応じて<br>対して<br>関して
やれることは全部やった。後は{{c1::ただ}}祈るのみだ。	ただ<br>たった<br>まだ<br>いわば
18歳人口の減少に{{c1::加え}}、おりからの不況で進学をあきらめる人もいて、多くの大学で学生が店員を下回った。	加え<br>したがって<br>よって<br>ともない
テレビドラマでは{{c1::あるまいし}}、現実離れした夢ばかり追っていてはいけないよ。	あるまいし<br>もとより<br>おろか<br>ばかりか
おかげさまで、病気は少しずつ良くなりつつ{{c1::あります}}。	あります<br>います<br>です<br>なります
皆様への感謝かたがた、ここに去年の業績を報告する{{c1::次第}}であります。	次第<br>こと<br>まで<br>ゆえん
タバコはやめようと思いつつも、{{c1::つい吸ってしまいます}}。	つい吸ってしまいます<br>あります<br>今はやめています<br>ついにやめることができました
彼女はたしかに健康的ではあるが、美しさの点ではまあまあ{{c1::といったところだ}}。	といったところだ<br>よりほかない<br>にはあたらない<br>というものではない
怒った民衆は町中で暴動を起こした。人々の目の中にあるのは、もはや狂気以外の{{c1::何ものでもなかった}}。	何ものでもなかった<br>何かであった<br>何かがなかった<br>ものだった
大地震の時、ラジオは一日中、一人ひとりの安否や水の出る場所を放送し続けた。これが、どれほど人々を安心させたか{{c1::はかりしれない}}。	はかりしれない<br>わかったものでない<br>知ったことではない<br>わかりきれない
働く女性が増え、労働時間も多様化しているのに、保育施設などの行政の対応は立ち遅れていると{{c1::言わざるを得ない}}。	言わざるを得ない<br>言えなくもない<br>言うべきではない<br>言いかねない
道もわからなくなったし、食べ物も食べてしまった。こうなった{{c1::上}}は、できるだけじっとしていて、助けが来るのを待つことにしよう。	上<br>中<br>末<br>最後
子供はひどい熱を出して苦しんだ。母親は「私が代われる{{c1::もの}}、代わってやりたい」と思いながら、寝ずに看病した	もの<br>わけ<br>得る<br>こと
私は時々自然にあこがれて山の家に行く。ところが３日もたたないうちに、都会の便利な生活が恋しくなってしまう。もう文明{{c1::なしには}}暮らせなくなってしまったらしい。	なしには<br>なくて<br>ないでは<br>なければ
私の今日あるのはあなたのおかげです。そのほかならぬあなたのお願いと{{c1::あれば}}、私にできる限りのことはさせてもらうつもりです。	あれば<br>きたら<br>いえども<br>いえば
私が不注意だった{{c1::ばかり}}に、子供にけがをさせてしまった。	ばかり<br>あげく<br>けっか<br>が最後
銀行にお金を借りに行ったときの行員の態度は、失礼{{c1::極まる}}ものだった。	極まる<br>比べられない<br>最高の<br>非常な
うーん、また世界新記録ですか。さすが天才の彼{{c1::なら}}ではのことですね。	なら<br>こそ<br>のみ<br>だから
動物の世界では１頭のメスを{{c1::めぐって}}、たくさんのオスが争うことは珍しくない。	めぐって<br>まわって<br>関して<br>対して
我々のチームが優勝できたのは、{{c1::ひとり}}選手だけでなく、応援してくれた皆さんのおかげです。	ひとり<br>多くの<br>たくさんの<br>たった
彼女には生まれ{{c1::ながらに}}身についた気品があった。	ながらに<br>ながらも<br>てから<br>たから
お父さんに{{c1::しても}}、お前が結婚して家を出ていくのはさびしい。だた娘の幸せが親の幸せだよ。	しても<br>関しても<br>ついても<br>あって
日本にいる間、アパートさがしから仕事のことまで、山本さんにはお世話になり{{c1::っぱなし}}でした。	っぱなし<br>きり<br>つづき<br>ばかり
近ごろの子供用の絵本は、けっこう大人の鑑賞にも{{c1::たえる}}ものが多い。	たえる<br>たえない<br>がまんする<br>かなう
えっ？　私、あなたにお金を借りていました{{c1::っけ}}？	っけ<br>なんて<br>ですか<br>とか
あの人の才能と飾らぬ人柄を、私は尊敬して{{c1::やまない}}。	やまない<br>しようがない<br>限りない<br>たまらない
母はいつも忙しい。さっき、料理を作っていたかと{{c1::思うと}}、今はもうミシンを踏んでいる。	思うと<br>したら<br>すると<br>見たら
身の回りのこともできない{{c1::くせに}}、「ぼくは自立している」なんて言わないで欲しいわ。	くせに<br>次第で<br>からして<br>に関せず
明日から夏休みの{{c1::こととて}}、学生の心はもう故郷に飛んでいる。	こととて<br>ために<br>ところで<br>からこそ
ひとりが批判の声をあげたのを{{c1::皮切りに}}、皆からいっせいに今まで押さえていた不満の声があがった。	皮切りに<br>最後に<br>最初に<br>封切りに
カーレーサーはかっこ良く見えても、危険{{c1::極まりない}}仕事だ。	極まりない<br>極まらない<br>極まった<br>極める
あの人は明るくて親切だが、ややおせっかいが過ぎる{{c1::きらい}}がある。	きらい<br>せい<br>がち<br>性能
裏切られたことを知った彼は、烈火の{{c1::ごとく}}怒り狂った。	ごとく<br>ごとき<br>ごとし<br>ごとに
全部答えなくて結構です。答え{{c1::うる}}範囲で答えてください。	うる<br>かねる<br>かねない<br>ざる
一生懸命お金を{{c1::かせいだところで}}、ほとんど税金に取られるのは馬鹿らしい。	かせいだところで<br>かせぐどころか<br>かせぐまいが<br>かせいだが最後
いつもスーツさえ着ていたらいいってものじゃない。時と場所に{{c1::応じた}}服装をしなくちゃね。	応じた<br>あたった<br>関した<br>際した
警官の家に泥棒が入ってつかまったって？　入られる警官も警官なら、入った泥棒も{{c1::泥棒}}だね。	泥棒<br>ばか<br>それまで<br>運が悪い
行くに{{c1::しろ、しろ}}行かないに{{c1::しろ、しろ}}、返事はくださいね。	しろ、しろ<br>か、か<br>なり、なり<br>つき、つき
あの大地震の翌月、防災訓練が行われた。時が時{{c1::だけに}}、いつもよりたくさんの参加者があった。	だけに<br>なら<br>だから<br>次第で
政治家が「前向きに検討します」と言うのは、「何もしないよ」と言う意味に{{c1::相違ない}}んですよ。	相違ない<br>ほかならない<br>変わらない<br>有り得ない
こんなに親切にしていただいて、感謝に{{c1::たえません}}。	たえません<br>たまりません<br>およびません<br>あたりません
乗っていた電車が途中で止まってしまい、降りようにも{{c1::降りられなかった}}。	降りられなかった<br>降りられた<br>降りかねなかった<br>しなかった
その男は、部屋に一つでもゴミが落ちていようものなら、{{c1::掃除をせずにはいられない}}。	掃除をせずにはいられない<br>気付かなかっただろう<br>全く気にしなかった<br>掃除せざるを得ない
カンニングがばれてしまったんだ。退学させられずには{{c1::すまない}}よ。	すまない<br>許せない<br>おけない<br>いけない
ほめられて喜んでいるのかい。それこそ、「主婦がやったにしては上出来だ」と、ばかにされているに{{c1::すぎない}}よ。	すぎない<br>あたらない<br>あたいしない<br>かたくない
彼女とはもう別れようと思ったのだが、彼女にあんなに{{c1::泣かれては}}、別れようにも別れられなかった。	泣かれては<br>泣かせては<br>泣いては<br>泣かされては
貧しいのに明るく生きている○○国の人々を見るに{{c1::つけても}}、夕食さえ家族そろって食べられない日本の経済発展とは、一体何だったんだろうと思わざるを得ない。	つけても<br>おいても<br>よっても<br>際して
少しでも立場の下の人がいると、いばらずには{{c1::いられない}}人がいるものだ。	いられない<br>いばるまい<br>たまらない<br>しようがない
聴くということは、耳が聞こえて、言葉がわかっていたら聞けるものではない。その話に興味と知識があって{{c1::はじめて}}、音が言葉として聞こえてくるのだ。	はじめて<br>はじめに<br>からこそ<br>すればこそ
今日も朝から青空で、どうやら雨は{{c1::降りそうもない}}。このままではダムの水が底をついてしまう。少しでも雨が降らないものか。	降りそうもない<br>降らんばかりだ<br>降りかねない<br>降らないそうだ
母親は病気の子供を、つき{{c1::っきり}}で看病した。	っきり<br>ながら<br>っぱなし<br>だけ
息子は模型飛行機を作るのが好きで、部屋中、飛行機{{c1::だらけ}}だ。	だらけ<br>きり<br>まみれ<br>ずくめ
工業が発展するに{{c1::つれて}}、環境も汚染されていった。	つれて<br>よって<br>反して<br>対して
Ａ氏のコンサートは東京を{{c1::皮切り}}に、名古屋、大阪、福岡と開かれる。	皮切り<br>ふみ切り<br>幕切れ<br>初切り
学校とアルバイトの後に、これだけの宿題をやるのはちょっとつらい{{c1::もの}}があります。	もの<br>はず<br>ほど<br>ほう
あの子は年の{{c1::わりに}}、大人びているね。	わりに<br>くせに<br>せいで<br>ために
今年は異常な事件が続く。第一、お天気{{c1::からして}}おかしい。	からして<br>からみて<br>ばかりか<br>だからこそ
これだけの仕事、とても一人ではやり{{c1::きれない}}よ。	きれない<br>かねない<br>終える<br>あげない
病気にでもならない{{c1::限り}}、この研究をやめる気はありません。	限り<br>ものを<br>なら<br>間は
老人介護は家族全員の力を{{c1::もって}}しても、なかなか困難なことだ。	もって<br>あたって<br>合わせて<br>とって
この本を{{c1::読んだ}}からといって、内容を全部覚えているわけではない。	読んだ<br>読んで<br>読む<br>読まない
あの話を{{c1::聞いて}}からというもの、怖くてトイレにも一人で行けない。	聞いて<br>聞いた<br>聞く<br>聞かない
彼女は非常に内気なる{{c1::がゆえに}}、友人をなかなか作れなかった。	がゆえに<br>ばかりに<br>ために<br>ごとく
早く医者に見せれば、助かった{{c1::ものを}}。	ものを<br>どころか<br>ところだ<br>ものの
これは初心者がよく犯し{{c1::がち}}な間違いです。気をつけてください。	がち<br>やすい<br>たがり<br>気味
先生の話によると、田中君がけがをした{{c1::とか}}。心配だなあ。	とか<br>とは<br>とも<br>かと
宿題をしてこなくてすみません。きのう、頭が痛かった{{c1::ものですから}}。	ものですから<br>というのです<br>わけですから<br>ことだもの
それが本当だとはっきり言い{{c1::きれる}}自信は、私にはありません。	きれる<br>つらぬく<br>かける<br>おわる
最初の彼、少しおかしいですね。私の思い過ごしだと言われれば{{c1::それまで}}ですけど。	それまで<br>それから<br>それほど<br>そればかり
最高責任者である大臣{{c1::にして}}、この程度の意識なのか。情けないったらない。	にして<br>からいって<br>からすると<br>としては
先生に「くれぐれもよろしく」と私の父も{{c1::申して}}おりました。	申して<br>おっしゃってえ<br>話されて<br>申されて
一度や二度の失敗の経験{{c1::なくして}}、本当の人生はわからない。	なくして<br>ないので<br>ないまでも<br>あるまいし
その国会議員は選挙に{{c1::勝たんがため}}に、なりふりかまわずどんな汚い手も使った。	勝たんがため<br>加藤がゆえ<br>勝つなり<br>勝つうち
できるだけあなたの希望に{{c1::そった}}プランを立てたいと思います。	そった<br>よった<br>かなえた<br>おける
男の子{{c1::であれ、であれ}}、女の子{{c1::であれ、であれ}}、とにかく無事に生まれてきてほしい。	であれ、であれ<br>といい、といい<br>につけ、につけ<br>なり、なり
お金がたくさんあるからといって、しあわせだという{{c1::わけではない}}。	わけではない<br>わけがない<br>はずがない<br>かもしれない
こんな難しい曲を歌えるのは、あの歌手をおいて{{c1::他にいるだろうか}}。	他にいるだろうか<br>いなくもない<br>歌いかねない<br>だれかいるだろう
私の不注意で事故が起きたと思うと、後悔しても後悔{{c1::しきれない}}。	しきれない<br>しようがない<br>したわけでもない<br>するはずがない
いくら言葉で説明されても、実際にやってみないことには{{c1::わかりそうもない}}。	わかりそうもない<br>わかりそうだ<br>わかりかねない<br>わかるはずだ
消しゴムを忘れてしまって。試験の間、拝借{{c1::させていただけますか}}。	させていただけますか<br>なさってください<br>させてあげましょう<br>してくれませんか
これがわからない{{c1::からといって}}、恥かしがることはない｡わからないのに、わかっているふりをする方が、よほど恥かしい?	からといって<br>ということは<br>からには<br>からこそ
女性が主婦として家事・育児に専念する生き方は、今でも一番社会的に認められ、生きやすい生き方である｡その{{c1::反面}}、経済力はなくなり、視野が狭くなるおそれがある。	反面<br>せいか<br>おかげで<br>あげく
彼は「私はやっていない」と言い張っているが、その事件を目撃した人が出てきて、しかも彼の指紋が現場で発見された｡{{c1::ことここ}}に至っては、彼も自白せざるをえないだろう。	ことここ<br>これまで<br>これここ<br>ここでも
外国で暮らすとき、言葉をおぼえること{{c1::にもまして}}大事なことは、その国の習慣をまずそのまま受け入れることだ｡それを批判することは、もっと後からで良い?	にもまして<br>によらず<br>に反して<br>にもかかわらず
今日は、大自然の中で思い切り自由に遊ぶ日だ｡だれが社長だとか部長だとか、そんな肩書きは{{c1::ぬき}}にして、お互い名前で呼び合おうではないか?	ぬき<br>そと<br>よそ<br>ほか
学生{{c1::たる}}者テレビばかり見ていないで、少しは勉強したらどうだ。	たる<br>になる<br>である<br>なる
妻に心配を{{c1::かけまいと}}、夫は事業の不振を妻には秘密にしていた?	かけまいと<br>かけるべく<br>かけようと<br>かけずに
私の知っている{{c1::限り}}において、そのような事実はありません。	限り<br>ところ<br>こと<br>のみ
世界広しと{{c1::いえども}}、これほど美しい山は他にないだろう?	いえども<br>いったものの<br>いわずとも<br>いうと
その国の言葉を知ること{{c1::なしに}}、その国の文化を知ることはできない?	なしに<br>ないで<br>なくて<br>ないと
電気工学の世界に{{c1::おける}}彼の名声は、ますます高まっていった?	おける<br>いたる<br>あたる<br>たいする
暴力をふるうような男とは、最初から結婚する{{c1::べき}}ではない。	べき<br>はず<br>わけ<br>こと
10年間Ⅰ日も休まなかったという練習があって{{c1::こそ}}、今日の彼がある?	こそ<br>のみ<br>から<br>ゆえ
まったく長男{{c1::といい、といい}}、次男{{c1::といい、といい}}、二人とも自分勝手なんだから！	といい、といい<br>なり、なり<br>であれ、であれ<br>だか、だか
やらなければ不平を言う。やった{{c1::としても}}不平を言う。どうすればいいの？	としても<br>どころか<br>から<br>なり
ベッドに入り、寝つくか寝つかないかの{{c1::うちに}}、電話のベルで起こされた?	うちに<br>ときに<br>間に<br>とたんに
お嬢様の結婚式には、ぜひわがホテルをご利用{{c1::いただけない}}でしょうか。	いただけない<br>なさらない<br>いただかない<br>いたせない
考えに考え{{c1::ぬいた}}結果、会社を辞めて独立することに決めました?	ぬいた<br>ぬけた<br>とおした<br>つづけた
私{{c1::さえ}}もっとしっかりしていれば、妻に苦労させなかったのに?	さえ<br>だけ<br>のみ<br>こそ
お菓子を取られたから怒るなんて。何て大人{{c1::げない}}人なんでしょうね。	げない<br>っぽい<br>びている<br>じみている
地球の気候は、だんだん暖かくなりつつ{{c1::ある}}。	ある<br>いる<br>である<br>している
最近、車を運転{{c1::しながら}}電話をかけている人が多い｡危険極まることだ。	しながら<br>がてら<br>してから<br>かたわら
彼の名声は日本国内は{{c1::もとより}}、海外まで知れわたっている?	もとより<br>もともと<br>もとから<br>もとづき
いつもは私が行きますが、時と場合に{{c1::よっては}}部下が行くこともあります?	よっては<br>ついては<br>したがって<br>次第で
お客様のご予算に{{c1::応じて}}、いろいろな物が用意してあります?	応じて<br>即して<br>関して<br>よらず
世の中が便利になった{{c1::反面}}、人と人とのふれあいが少なくなった?	反面<br>あげく<br>おかげで<br>当面
本日を{{c1::もちまして}}、私は会長職を辞めさせていただきたいと思います?	もちまして<br>なりまして<br>限りまして<br>論じまして
これは何も{{c1::ひとり}}日本のみならず、世界的な問題である?	ひとり<br>ひとつ<br>一国<br>一体
この競技場は5万人{{c1::から}}の客を収容できる?	から<br>なり<br>だけに<br>さえ
あ、ここではタバコはご遠慮{{c1::ねがえません}}でしょうか。	ねがえません<br>いたしません<br>もらいます<br>いただきません
この薬をぬったら、にきびが治るどころか{{c1::ますますひどくなった}}。	ますますひどくなった<br>すぐよくなるだろう<br>はたしてきれいに治ってしまった<br>あまり効き目はない
いくら勉強しても、試験当日に病気になったら{{c1::それまでだ}}。	それまでだ<br>何でもない<br>それからだ<br>何にもない
スイッチを押すだけで洗濯ができるなんて、私の若い時と比べて、便利な世の中に{{c1::なったものだ}}。	なったものだ<br>なりかねない<br>なったそうだ<br>なったところだ
あの歌手ときたらダンスは上手だが、肝心の歌はとても下手で{{c1::聞かれたものではない}}。	聞かれたものではない<br>聞かずにはおかない<br>聞くどころではない<br>聞いたはずがない
彼女は、確かに美人と言えないこともないが、{{c1::私の好みではない}}。	私の好みではない<br>言わないでおこう<br>しかもスタイルもいい<br>皆がきれいだと言っている
犬や猫を飼うことは、人間の一生を早送りして見るようなものだ｡子供時代の可愛さ、成長する楽しみ、老いていくさびしさ、死の悲しみ｡それら{{c1::を通して}}命の重さを身をもって知ることができる?	を通して<br>をめぐって<br>にわたって<br>に即して
新しい果物や野菜が日本に入ってくると、器用な日本人は色や形まで改良し、日本{{c1::ならでは}}の芸術品に作りあげた｡そのかわり値段が高くなり、本来の味がなくなったような気がする?	ならでは<br>だけ<br>こそ<br>なり
私はその困っている学生に、空いている部屋をただで提供した｡学生は私のために力仕事をしてくれたり、話し相手になってくれる。お互いにとっていいこと{{c1::ずくめ}}の取り引きだった。	ずくめ<br>のみ<br>まみれ<br>だらけ
この病気は早く治療しないと命取りにもなりかねない。事情は{{c1::ともかく}}、すぐ入院しなさい｡勉強は後でがんばれば取り返せるのだし、お金のことは私がなんとかしよう。	ともかく<br>いかんで<br>もとより<br>とかく
「気のおけない人」というのは「気楽に付き合える人」という意味だが、今の若い人は「信用できない人」という意味で使っているらしい｡それに{{c1::つけても}}、日本語の変化の早さにはおどろくべきものがある。	つけても<br>よっても<br>おいても<br>関しても
優勝戦は、意外に{{c1::あっけなく}}勝負が決まった。	あっけなく<br>そっけなく<br>はかなく<br>ものたりなく
この年は、周辺から人が集まりすぎて{{c1::過密}}状態だ。	過密<br>窮屈<br>不潔<br>不服
病気が悪化し、{{c1::ろくに}}ものも食べられなくなった。	ろくに<br>せめて<br>やけに<br>まして
聞き手の{{c1::反応}}がないと、スピーチをしていて話しづらい。	反応<br>返答<br>対応<br>応答
駅前の再開発工事は、順調にいけば来年の１０月に完了する{{c1::見込み}}だ。	見込み<br>見合い<br>見積もり<br>見晴らし
仕事はできるだけ早めに始めるように{{c1::こころがけて}}いる。	こころがけて<br>とりくんで<br>いどんで<br>はかどって
田中さんは目上の人にはていねいだが、下の人にはとても{{c1::ぞんざいに}}なる。	ぞんざいに<br>おろそかに<br>おろかに<br>つきなみに
「近代」という{{c1::概念}}を、わかりやすく正確に説明するのは難しい。	概念<br>意識<br>文脈<br>様相
山田さんは頼りにならないと思っていたが、今度の活躍を見てその考えを{{c1::あらためた}}。	あらためた<br>おさめた<br>うちきった<br>おいだした
このアンケートに協力するかしないかは自由で、{{c1::強制}}はしないということにしたい。	強制<br>圧迫<br>催促<br>一致
病院は日曜と祝日は休みだが、{{c1::緊急}}の場合は診てもらえる。	緊急<br>異常<br>多忙<br>不意
このいすは{{c1::デザイン}}はいいが、すわり心地が悪い。	デザイン<br>ジャンル<br>モデル<br>デッサン
選挙の投票は権利でもあるが義務でもある。かんたんに{{c1::棄権}}してはいけない。	棄権<br>欠席<br>廃棄<br>放置
アルバイトの条件は、会社と{{c1::交渉}}して決めることになっている。	交渉<br>会見<br>対話<br>譲歩
彼は{{c1::たくましい}}から、多少困難な状況にあってもやっていける。	たくましい<br>このましい<br>いやらしい<br>なれなれしい
通信手段の発達のおかげで、{{c1::茶の間}}にいながら世界各地の様子を知ることができる。	茶の間<br>床の間<br>客間<br>すき間
あなたに{{c1::たてかえて}}もらったお金、返さなくちゃ。いくらだったっけ。	たてかえて<br>つめかえて<br>ふりかえて<br>もちかえて
失敗を重ねても、いっこうに気にする様子はない。あいつは実に{{c1::しぶとい}}男だ。	しぶとい<br>すばしこい<br>あっけない<br>くすぐったい
彼女は何事にも{{c1::じっくり}}取り組むタイプで、仕事はおそいが確実だ。	じっくり<br>くっきり<br>てっきり<br>めっきり
彼と彼女は、高校の先輩と後輩という{{c1::あいだがら}}だそうです。	あいだがら<br>なかま<br>つながり<br>どうし
あんなに部下を{{c1::けなして}}ばかりいないで、たまにはほめてもいいのに。	けなして<br>こなして<br>せかして<br>くつがえして
彼がそこへ行ったという事実は{{c1::明白}}で、疑うべくもない。	明白<br>明瞭<br>明朗<br>明確
情報は、{{c1::ジャンル}}別にファイルを作って整理している。	ジャンル<br>ジャンパー<br>ジャンボ<br>ジャンプ
彼は{{c1::たくましい}}から、多少困難な状況にあってもやっていける。	たくましい<br>このましい<br>いやらしい<br>なれなれしい
優勝戦は、意外に{{c1::あっけなく}}勝負が決まった。	あっけなく<br>そっけなく<br>はかなく<br>ものたりなく
この都市は、周辺から人が集まりすぎて{{c1::過密}}状態だ。	過密<br>窮屈<br>不潔<br>不服
病気が悪化し、{{c1::ろくに}}ものも食べられなくなった。	ろくに<br>せめて<br>やけに<br>まして
聞き手の{{c1::反応}}がないと、、スピーチをしていて話づらい。	反応<br>返答<br>対応<br>応答
駅前の再開発工事は、順調にいけば来年の１０月に完了する{{c1::見込み}}だ。	見込み<br>見合い<br>見積もり<br>見晴らし
仕事はできるだけ早めに始めるように{{c1::こころがけて}}いる。	こころがけて<br>とりくんで<br>いどんで<br>はかどって
田中さんは目上の人にはていねいだが、下の人にとても{{c1::ぞんざいに}}なる。	ぞんざいに<br>おろそかに<br>おろかに<br>つきなみに
「近代」という{{c1::概念}}を、わかりやすく正確に説明するのは難しい。	概念<br>意識<br>文脈<br>様相
山田さんは頼りにならないと思っていたが、今度の活躍を見て考えを{{c1::あらためた}}。	あらためた<br>おさめた<br>うちきった<br>おいだした
このアンケートに協力するかしないかは自由で、{{c1::強制}}はしないということにしたい。	強制<br>圧迫<br>催促<br>一致
病院は日曜と祝日は休みだが、{{c1::緊急}}の場合は診てもらえる。	緊急<br>異常<br>多忙<br>不意
このいすは{{c1::デザイン}}はいいが、すわり心地が悪い。	デザイン<br>ジャンル<br>モデル<br>デッサン
選挙の投票は権利でもあるが義務でもある。かんたんに{{c1::棄権}}してはいけない。	棄権<br>欠席<br>廃棄<br>放置
アルバイトの条件は、会社と{{c1::交渉}}して決めることになっている。	交渉<br>会見<br>対話<br>譲歩
目を閉じると、楽しかった学生時代の思い出が{{c1::よみがえる}}。	よみがえる<br>ちかづける<br>すきとおる<br>たてまつる
彼はいつも{{c1::あくどい}}商売をする。	あくどい<br>まぶしい<br>はかない<br>けむたい
うちの子は運転が乱暴で、事故を起こすのではないかと、わたしはいつも{{c1::はらはら}}している。	はらはら<br>しみじみ<br>おどおど<br>ぼつぼつ
あの人は常に努力を{{c1::おこたらない}}ので、尊敬されている。	おこたらない<br>おかさない<br>かばわない<br>かたよらない
この事業を実行するためには、まず人材を{{c1::確保}}する必要がある。	確保<br>確立<br>確率<br>確信
何回会議をやっても結論が出ないので、{{c1::つくづく}}いやになった。	つくづく<br>わざわざ<br>ぞくぞくと<br>くれぐれも
畑に{{c1::まいた}}小麦が芽を出した。	まいた<br>まった<br>ました<br>まげた
公式の席では、その場に{{c1::ふさわしい}}服装が要求される。	ふさわしい<br>めざましい<br>たくましい<br>みぐるしい
いくら努力しても成果があがらないので、{{c1::むなしく}}なってきた。	むなしく<br>とうとく<br>ひさしく<br>たやすく
海外で買ってきた物を空港で{{c1::没収}}されることがある。	没収<br>収容<br>徴収<br>収集
たいこの音が聞こえてきて、祭りの{{c1::ムード}}がいちだんと盛り上がってきた。	ムード<br>ポーズ<br>ブーム<br>リード
この古い寺の庭は{{c1::おもむき}}がある。	おもむき<br>おおすじ<br>おとも<br>おそれ
時間がないので、話してください。	おおまかに<br>ぞんざいに<br>にわかに<br>おろそかに
鈴木さんはいつも{{c1::無茶な}}ことを言って、まわりの人を困らせる。	無茶な<br>無念な<br>無効な<br>無口な
わたしの秘書はとても{{c1::てぎわ}}がいいので助かっている。	てぎわ<br>しらべ<br>こころえ<br>うちわけ
このスープは塩の{{c1::加減}}がむずかしい。	加減<br>調子<br>場合<br>場合
田中さんの結婚パーティーは、とても{{c1::なごやか}}だった。	なごやか<br>ゆるやか<br>おろそか<br>しなやか
知らない漢字でも、その部首を見て意味を{{c1::類推}}できることがある。	類推<br>予言<br>推進<br>予知
山田さんは、きょうのこの会のために、{{c1::わざわざ}}遠くから来てくださいました。	わざわざ<br>たっぶり<br>じっくり<br>つくづく
けがをしたが、その場ですぐ{{c1::応急}}処置をしたので、大事にはいたらなかった。	応急<br>救助<br>救援<br>応援
仕事の{{c1::合間}}にほかの用事をすませました。	合間<br>手間<br>空間<br>仲間
これは重さの割に{{c1::かさばる}}荷物だ。	かさばる<br>かせぐ<br>かすむ<br>かぶれる
最近の青少年はしっかりしているようだが、精神的に{{c1::もろい}}面がある。	もろい<br>だるい<br>ゆるい<br>しぶい
首相の軽率な発言で、良好であった両国の関係が{{c1::きしみはじめた}}。	きしみはじめた<br>きたえはじめた<br>きずきはじめた<br>きざみはじめた
堀さんは{{c1::かお}}が広いから、それについての専門家を紹介してもらうといい。	かお<br>くち<br>まゆ<br>みみ
非常時には、{{c1::迅速な}}行動が要求される。	迅速な<br>敏感な<br>切実な<br>頻繁な
年をとったせいか、何をするのも{{c1::わずらわしい}}。	わずらわしい<br>なやましい<br>みすぼらしい<br>まぎらわしい
鈴木さんは{{c1::スタイル}}がいいから、どんな洋服でもよく似合う。	スタイル<br>スマート<br>ストップ<br>スタミナ
人間関係でこんなに苦労するなら、{{c1::いっそ}}この会社をやめてしまおう。	いっそ<br>いっしんに<br>いったい<br>いっこうに
政府が、この問題にどう{{c1::対処}}するか注目される。	対処<br>対比<br>対面<br>対等
駅から{{c1::徒歩}}３分の便利な所に住んでいる。	徒歩<br>歩行<br>進歩<br>散歩
将来有望な人材を求める。年齢は３０歳まで。{{c1::資格}}は問わない。	資格<br>体格<br>人格<br>性格
日本ほど国民の所得の{{c1::格差}}が少ない国は多くない。	格差<br>差別<br>誤差<br>錯誤
目に見えない殺菌を、顕微鏡で{{c1::拡大}}して見る。	拡大<br>膨張<br>拡張<br>膨大
高校時代の友達が集まって、株式会社を{{c1::設立}}した。	設立<br>確立<br>私立<br>樹立
死刑制度の{{c1::廃止}}を呼びかける。	廃止<br>廃棄<br>閉鎖<br>停止
初めての料理なので、味は{{c1::保証}}できません。	保証<br>補助<br>保障<br>補償
「日本人はあいまいだ」という{{c1::偏見}}をもたずに、接してほしい。	偏見<br>意義<br>異議<br>意見
消化{{c1::器官}}がガンに冒された。	器官<br>機関<br>器具<br>部品
農作物の収穫は、{{c1::気象}}条件に大きく左右される。	気象<br>天候<br>気候<br>天気
酒の席とはいえ、みんなの前で「結婚する」と{{c1::宣言}}してしまった。	宣言<br>表現<br>伝言<br>説得
犯人は現行犯で{{c1::逮捕}}された。	逮捕<br>収穫<br>捕獲<br>獲得
政治家という職業は、金銭感覚が{{c1::麻痺}}してしまうのだろうか？	麻痺<br>疲労<br>麻酔<br>熟睡
先生に作文を{{c1::添削}}してもらった。	添削<br>削減<br>軽減<br>削除
マンガの読み過ぎで、現実と{{c1::空想}}違いがわからなくなった。	空想<br>高架<br>架空<br>思想
歩道を歩いていたら、{{c1::突然}}ビルの壁が崩れ落ちて来たのだった。	突然<br>意外<br>案外<br>不意
大都市の人口{{c1::密度}}が低くなってきている。	密度<br>濃度<br>適度<br>制度
空いている教室を{{c1::無断}}で使用してはいけません。	無断<br>無論<br>無口<br>無念
彼は同僚とも、また上司とも{{c1::要領}}良くつきあえる将来有望な社員である。	要領<br>項目<br>事項<br>要項
この車は特にエンジンの{{c1::性能}}が優れている。	性能<br>個性<br>適性<br>性質
テレビ番組での差別発言に対して{{c1::抗議}}の電話が殺到した。	抗議<br>反抗<br>抵抗<br>抗争
社長を神や仏のように{{c1::崇拝}}する社員たち。	崇拝<br>祈願<br>支持<br>信仰
台風でストップしていた電車がけさ{{c1::復旧}}した。	復旧<br>回復<br>復興<br>復活
天候と売り上げには{{c1::密接}}な関係がある。	密接<br>集中<br>密集<br>過密
試験の会場へ向かう途中で事故に遭い、入院した友人に{{c1::同情}}する。	同情<br>同意<br>同感<br>合意
エネルギーの{{c1::浪費}}は避けなければならない。	浪費<br>経費<br>消化<br>費用
友人に日本留学の{{c1::動機}}をたずねた。	動機<br>契機<br>機械<br>原始
プライベートなことまで{{c1::干渉}}しないでください。	干渉<br>交渉<br>会見<br>会談
５万人を{{c1::収容}}できるスタジアムが完成した。	収容<br>収入<br>納入<br>許容
{{c1::審査}}の結果、優勝は韓国のカンさんに決定致しました。	審査<br>検査<br>捜査<br>調査
都市では、いたるところに{{c1::監視}}カメラがついている。	監視<br>視察<br>観察<br>監督
わたし、機械に弱くて、コピーの{{c1::操作}}も一人じゃできないんです。	操作<br>操縦<br>運転<br>作動
人間が暗やみを恐れるのは{{c1::本能}}である。	本能<br>体質<br>本質<br>本音
なんと１８歳の若さで、驚異的な新記録を{{c1::達成}}した。	達成<br>到着<br>上達<br>到達
惜しくも敗れたが、再度{{c1::挑戦}}したいと思う。	挑戦<br>抗争<br>戦争<br>対抗
各国の{{c1::首脳}}が集まって、会議が行われた。	首脳<br>本部<br>政府<br>機関
困っている人を見たら、何とかしてあげたいと思うのは{{c1::人情}}である。	人情<br>心情<br>心中<br>感情
仕事の帰り、つい酒の{{c1::誘惑}}に負けて、家に帰るのが遅くなった。	誘惑<br>勧誘<br>誘拐<br>推薦
駅前に{{c1::放置}}された自転車通行の妨げとなる。	放置<br>廃棄<br>廃棄<br>廃止
土、日には学校の校庭が市民に{{c1::開放}}される。	開放<br>公開<br>公表<br>解放
最初にミニスカートが{{c1::流行}}したのはいつ頃だったかな？	流行<br>流通<br>通行<br>交流
逃亡中の犯人は指名{{c1::手配}}された。	手配<br>手際<br>手分け<br>手回し
彼女は今、次の作品の{{c1::構想}}を練っているところだ。	構想<br>想像<br>創作<br>創造
今や全世界の映像が、衛星{{c1::中継}}で見られるようになった。	中継<br>後継<br>継続<br>存続
今まで冗談ばかり言っていた彼が、ついに{{c1::本気}}になった。	本気<br>根気<br>根本<br>根性
筆記試験に合格したら、つぎは{{c1::面接}}が待っている。	面接<br>接近<br>接触<br>直接
自分の意見を主張するだけでなく、自ら{{c1::実践}}することが大事だ。	実践<br>実際<br>実質<br>実態
用紙の解答欄に鉛筆で{{c1::記入}}すること。	記入<br>記録<br>登録<br>目録
「漢字の勉強をするように」とあれだけ{{c1::忠告}}したのに。	忠告<br>中傷<br>申告<br>非難
国会議員は{{c1::選挙}}によって選ばれる。	選挙<br>選択<br>抽選<br>選考
写真を{{c1::合成}}して人をだます。	合成<br>合併<br>合同<br>提携
このマンションは姉と私の二人で{{c1::共有}}している。	共有<br>共同<br>両立<br>共存
友人の車を借りて、傷をつけてしまった。お金で{{c1::弁償}}するしかあるまい。	弁償<br>返済<br>返還<br>弁解
この作品は、およそ１０年にわたる血と涙の{{c1::結晶}}である。	結晶<br>結束<br>団結<br>結成
{{c1::はるかな}}昔から、人は戦争を繰り返してきた。	はるかな<br>おおまかな<br>おおげさな<br>ひそかな
今こそ「人はなぜ教育が必要なのか」という{{c1::素朴}}な疑問に立ち戻るべきだ。	素朴<br>素質<br>地味<br>純粋
毎日毎日人は、{{c1::おびただしい}}量の情報を消費している。	おびただしい<br>ややこしい<br>うっとうしい<br>ばかばかしい
秋の夜、都会でも窓を開ければ、{{c1::かすかに}}虫の声が聞こえてくる。	かすかに<br>こまやかに<br>あやふやに<br>こっけいに
「お金が無くなったら借りれば良い」という{{c1::安易な}}考えは通用しない。	安易な<br>簡単な<br>簡素な<br>容易な
この花瓶は倒れやすいので、{{c1::ひらたい}}ものの上に置いてください。	ひらたい<br>たやすい<br>ひさしい<br>しぶとい
試験中なのに、毎日雨ばかりで{{c1::ゆううつ}}です。	ゆううつ<br>あざやか<br>つぶら<br>しとやか
渡っていた橋が崩れ落ちるという{{c1::不吉な}}夢を見た。	不吉な<br>不審な<br>不明な<br>不当な
いくら努力してもよい結果が得られず、{{c1::むなしく}}なってきた。	むなしく<br>あくどく<br>くすぐったく<br>あっけなく
まる一日、誰とも口を利かずに過ごす{{c1::孤独な}}老人が増えている。	孤独な<br>自在な<br>独自な<br>特有な
日本での一人暮らし。最初はとても、{{c1::こころぼそい}}思いをした。	こころぼそい<br>こころづよい<br>こころよい<br>のぞましい
会社ではやはり、上司に{{c1::忠実な}}部下が求められる。	忠実な<br>円満な<br>勤勉な<br>生真面目な
社会に出て３カ月、厳しい現実の前で夢は{{c1::はかなく}}消えて行った。	はかなく<br>あさましく<br>すばしこく<br>そっけなく
一時はどうなることかと心配したが、やっと{{c1::円満に}}解決した。	円満に<br>温和に<br>健全に<br>柔軟に
あまり無理をせず、自分に{{c1::ふさわしい}}勉強方法を見つけることが大事だ。	ふさわしい<br>たやすい<br>まちどおしい<br>せつない
彼女の機嫌が悪いときには、そっとしておくのがいちばん{{c1::のぞましい}}。	のぞましい<br>まちどおしい<br>なやましい<br>あさましい
今度の旅行の{{c1::おおまかな}}予定を説明します。	おおまかな<br>おおげさな<br>あやふやな<br>なめらかな
どんなときもあわてずに、{{c1::冷静な}}判断ができるようになりたいものだ。	冷静な<br>冷淡な<br>冷酷な<br>残酷な
昔は病気ばかりしていたが、サッカー部に入ってから{{c1::たくましく}}なった。	たくましく<br>しぶとく<br>すばしこく<br>ものたりなく
毎日の復習を{{c1::おろそか}}にしてはいけない。油断大敵である。	おろそか<br>おろか<br>ゆるやか<br>しなやか
画家の彼女は性格は{{c1::地味}}だが、作品にはとても派手な色を使う。	地味<br>簡単<br>悲惨<br>独自
ただのかぜで入院するなんて{{c1::おおげさな}}人だなあ。	おおげさな<br>あざやかな<br>つぶらな<br>しとやかな
旅行も買物もカード一枚でオーケー。もう{{c1::わずらわしい}}手続きはいりません。	わずらわしい<br>ひさしい<br>たやすい<br>あくどい
犯行直前に現場で{{c1::不審な}}人物を見かけたという証言があった。	不審な<br>不振な<br>不明な<br>不良な
誰にも言わずにひとりで{{c1::ひそかに}}会社の設立を計画している。	ひそかに<br>あやふやに<br>こっけいに<br>すこやかに
最後まであきらめずに{{c1::しぶとく}}がんばる。	しぶとく<br>そっけなく<br>あっけなく<br>ややこしく
海外旅行は初めてだが、経験豊富な友人と一緒なので{{c1::心強い}}。	心強い<br>浅ましい<br>快い<br>悩ましい
講演の内容は、別に珍しくもない{{c1::ありふれた}}話だった。	ありふれた<br>とろけた<br>あつらえた<br>たるんだ
離婚の話が{{c1::こじれて}}、とうとう法廷で争うことになってしまった。	こじれて<br>こだわって<br>ごまかして<br>もがいて
競争率５０倍の難関を{{c1::くぐり}}抜けて、ついに念願のＮ大学に入学した。	くぐり<br>ねだり<br>たどり<br>しくじり
いつも夜道で{{c1::くちずさむ}}歌は学生時代の思い出の歌である。	くちずさむ<br>ばらまく<br>さえずる<br>ののしる
国民のひたむきな努力が、日本経済の発展を{{c1::もたらした}}。	もたらした<br>もてなした<br>そびえさせた<br>のぞませた
出費が{{c1::かさんで}}、赤字になってしまった。	かさんで<br>さらって<br>しみて<br>こもって
なんだかこの写真は、顔が{{c1::ぼけて}}見える。	ぼけて<br>はげて<br>ばけて<br>ばてて
宝くじが当たった！夢かと思って頬を{{c1::つねったら}}、やっぱり……。	つねったら<br>むしったら<br>めくったら<br>いじったら
冷たい水が、歯に{{c1::しみて}}、思わず顔をゆがめた。	しみて<br>とぎれて<br>さわって<br>いたわって
今、彼は興奮しているから、気に{{c1::さわる}}ようなことは言わない方がいいよ。	さわる<br>もめる<br>あざわらう<br>さえる
あとちょっとのところで{{c1::しくじって}}、契約書にハンコをもらえなかった。	しくじって<br>さぼって<br>へりくだって<br>おどして
仕方がない。今回だけは、目を{{c1::つぶって}}見なかったことにしてあげよう。	つぶって<br>よけて<br>さらって<br>うつむいて
初めて友達のうちに行った時、とてもていねいな{{c1::もてなし}}を受けた。	もてなし<br>しつけ<br>いたわり<br>こだわり
ここは開かずの踏切で、朝夕は電車が{{c1::とぎれる}}ことがない。	とぎれる<br>とがめる<br>さしかかる<br>くぐる
映画の上映時間について電話で{{c1::といあわせた}}。	といあわせた<br>へりくだった<br>ききあわせた<br>みなした
都会の中心には、たいてい高層ビルが{{c1::そびえて}}いる。	そびえて<br>うつむいて<br>おどして<br>ばらまいて
記憶を頼りに、やっと１５年前の思い出の地に{{c1::たどり}}着いた。	たどり<br>もがき<br>はまり<br>ねだり
濃いコーヒーを飲んだら、頭が{{c1::さえて}}勉強がどんどん進んだ。	さえて<br>ばけて<br>おだてて<br>はげて
疑われている友人を{{c1::かばって}}、うその証言をした。	かばって<br>よけて<br>ののしって<br>ごまかして
結果よりも過程が大事、勝敗には{{c1::こだわら}}ない。	こだわら<br>はじらわ<br>とがめ<br>いたわら
するのはいつも自慢話ばかり、失敗すると他人のせいにする彼にはみんな{{c1::あきれて}}いる。	あきれて<br>とろけて<br>おどして<br>さらって
何があったのだろう、彼女は{{c1::うつむいた}}ままで、呼んでも返事をしない。	うつむいた<br>ごまかした<br>けなした<br>みなした
学生時代、授業を{{c1::さぼって}}映画を見に行ったこともあった。	さぼって<br>ごまかして<br>よけて<br>はじらって
静かな図書室。本のページを{{c1::めくる}}音だけが聞こえる。	めくる<br>もてる<br>むしる<br>もめる
彼は一週間、自分の部屋に{{c1::こもり}}きりで論文を書き上げた。	こもり<br>もがき<br>はまり<br>つまり
事件解決まであと一歩という所に{{c1::さしかかった}}時、また新たな殺人が起こった。	さしかかった<br>さしひいた<br>さしつかえた<br>さしだした
幼い頃からの家庭での礼儀作法の{{c1::しつけ}}は大事である。	しつけ<br>たるみ<br>とがめ<br>さえずり
応援していたチームが、あんなに{{c1::あっさり}}負けるなんて。	あっさり<br>さっぱり<br>すっきり<br>がっくり
お寺の参道には、土産物を売る店が{{c1::ずらっと}}並んでいる。	ずらっと<br>ちらっと<br>きちっと<br>ぐっと
実際日本で暮らしてみて、{{c1::つくづく}}日本の物価は高いと思った。	つくづく<br>いやいや<br>ずるずる<br>ぼつぼつ
今住んでいるこの辺りは、{{c1::かつて}}海の底だったと言う。	かつて<br>あえて<br>いたって<br>かねて
トイレに行って飛行機に乗り遅れたなんて、{{c1::いかにも}}彼らしいね。	いかにも<br>いかに<br>いやに<br>ことに
災害対策の品はそろえたが、{{c1::いざ}}という時、本当に訳に立つのかな。	いざ<br>さぞ<br>さも<br>いまだ
私は、{{c1::いまだ}}かつて嘘をついたことがございません。	いまだ<br>なにより<br>もはや<br>うまれつき
予想が{{c1::ずばり}}当たって、テストは満点だった。	ずばり<br>くっきり<br>すんなり<br>まるっきり
予想が{{c1::まるっきり}}外れて、テストは０点だった。	まるっきり<br>もっぱら<br>はなはだ<br>まさしく
「事故で家族が入院」と聞いて心配したが、無事だと分かり{{c1::ほっと}}した。	ほっと<br>さっと<br>ぐっと<br>ひょっと
消費者の反応は{{c1::まちまち}}で、商品についての特別な意見はなかった。	まちまち<br>ぼつぼつ<br>ちやほや<br>むちゃくちゃ
残業が長引いて夜遅くなったが、{{c1::かろうじて}}終電に間に合った。	かろうじて<br>まして<br>しいて<br>もしかして
事故で入院した母が心配で、この２日、夜も{{c1::ろくに}}寝ていない。	ろくに<br>もろに<br>まことに<br>やけに
こちらが提示した条件はどれもこれも{{c1::ことごとく}}拒否され、取引は失敗した。	ことごとく<br>かわるがわる<br>しょっちゅう<br>ひたすら
また今日も徹夜だ。{{c1::どうやら}}夜が明けてきたらしい。	どうやら<br>どうにか<br>とかく<br>いまさら
電車は予定どうり、１０時{{c1::きっかり}}に到着した。	きっかり<br>きっちり<br>がっちり<br>がっかり
反応を見るために、父は{{c1::あえて}}子供の意見に反対した。	あえて<br>いやいや<br>いたって<br>いやに
たった１枚の絵が、{{c1::なんと}}１億円もすると言う。	なんと<br>なんだか<br>なんて<br>なにとぞ
電車が揺れて倒れそうになったので、{{c1::とっさに}}窓ガラスに手をついた。	とっさに<br>ことに<br>やけに<br>もはや
結婚を申し込んだら、{{c1::きっぱり}}断れてしまった。	きっぱり<br>げっそり<br>うんざり<br>くっきり
あの２人は{{c1::しょっちゅう}}けんかしている。	しょっちゅう<br>いやに<br>てんで<br>とかく
そんなに思いどうりに{{c1::すんなり}}行くとは思えない。	すんなり<br>くっきり<br>げっそり<br>がっしり
この薬は水を入れると{{c1::さっと}}溶けて、効きめが早い。	さっと<br>ちらっと<br>ぐっと<br>ひょっと
新学期になり{{c1::ぼつぼつ}}桜も咲き始めた。	ぼつぼつ<br>いやいや<br>ずるずる<br>ぺこぺこ
日本語が{{c1::いかに}}難しいか、言葉では説明できない。	いかに<br>いやに<br>もろに<br>ことに
酒の中でも私は{{c1::とりわけ}}ワインを好む。	とりわけ<br>なにとぞ<br>ことによると<br>あんのじょう
友達が試験に合格した。ご両親も{{c1::さぞ}}うれしいことだとう。	さぞ<br>さも<br>なるたけ<br>まさしく
やった！成績が{{c1::アップ}}したぞ。	アップ<br>ダウン<br>オープン<br>オーバー
{{c1::アンケート}}の結果を分析して、グラフにして会議に提出した。	アンケート<br>データ<br>ファイル<br>カルテ
「個人」を前提として、社会という{{c1::システム}}は成り立っている。	システム<br>レギュラー<br>サイクル<br>オートマチック
ずいぶんはでな{{c1::デザイン}}の車が止まったと思ったら、彼だった。	デザイン<br>デッサン<br>メロディー<br>センス
彼は性格に問題があるのか、{{c1::トラブル}}ばかり起こしている。	トラブル<br>ストレス<br>ショック<br>ムード
彼女の家はとても{{c1::ユニーク}}で、地下が玄関になっている。	ユニーク<br>ハード<br>ベスト<br>ソフト
庭なら、せめて子どもが走り回れるぐらいの{{c1::スペース}}が欲しい。	スペース<br>フロント<br>ホール<br>コーナー
正確に情報を{{c1::キャッチ}}して、全世界に送るジャーナリストたち。	キャッチ<br>リード<br>コントロール<br>チェンジ
{{c1::ルール}}を守らない者は自由を拘束されるというのも、事実だ。	ルール<br>マーク<br>ジャンル<br>ポイント
人気歌手Ｊ。来月{{c1::ファン}}待望の新曲が発売される。	ファン<br>ブーム<br>ゲスト<br>スター
もううんざりの雨続きと仕事の{{c1::ストレス}}を解消するには、カラオケが一番。	ストレス<br>レッスン<br>ショック<br>インフレ
パソコン通信という新しい{{c1::メディア}}が開発された。	メディア<br>サイズ<br>コマーシャル<br>マスコミ
円高で日本の自動車{{c1::メーカー}}が打撃を受けている。	メーカー<br>コーナー<br>ホール<br>ラベル
この本の{{c1::タイトル}}は『日本語能力試験に出る文字・語彙』だ。	タイトル<br>コメント<br>ヒント<br>メッセージ
この文章は抽象的で{{c1::ポイント}}がつかみにくい。	ポイント<br>ピント<br>ヒント<br>ジャンル
彼女は自分の感情のまで{{c1::コントロール}}できる、とても理想的な女性だ。	コントロール<br>ボイコット<br>オープン<br>リード
友達の誕生日。プレゼントに添えて{{c1::メッセージ}}贈る。	メッセージ<br>レギュラー<br>レッスン<br>コーナー
早く、言葉の{{c1::ニュアンス}}が使い分けられるようになりたい。	ニュアンス<br>ショック<br>サイクル<br>ブーム
駅の近くにまた新しいホテルが{{c1::オープン}}した。	オープン<br>オーバー<br>リード<br>チェンジ
貴重品をホテルの{{c1::フロント}}にあずける。	フロント<br>ホール<br>バック<br>コーナー
どんな{{c1::ジャンル}}の本が好きですか？	ジャンル<br>サイクル<br>センス<br>ファイル
事故で息子を亡くし、{{c1::ショック}}のあまり母親は倒れてしまった。	ショック<br>インフレ<br>ムード<br>ボイコット
結果よりも過程が大事。何事にも{{c1::ベスト}}をつくす。	ベスト<br>ゲスト<br>ソフト<br>ブーム
不況が続き、賃金を{{c1::カット}}した会社もあるという。	カット<br>ボイコット<br>リード<br>オーバー
気持ちを穏やかにしてくれるこの曲の{{c1::メロディー}}が好きだ。	メロディー<br>レッスン<br>デッサン<br>データ
次から次に仕事が入ってきて、電話も一度に何本もかかってくるし、もう忙しくて{{c1::め}}が回りそうだ。	め<br>あし<br>て<br>みみ
不況が続き、経営不振という理由で、会社を{{c1::くび}}になった人もいるそうだ。	くび<br>はな<br>あし<br>かお
建築工事の業者が{{c1::て}}を抜いたせいか、このビルはあちこちで雨漏りがする。	て<br>あし<br>こし<br>かた
わたしのうちは学校から{{c1::めとはな}}の先のところにあります。	めとはな<br>てとあし<br>めとくち<br>めとみみ
毎日、一生懸命勉強したおかげで、成績優秀な彼女と{{c1::かた}}を並べるまでになった。	かた<br>あたま<br>こし<br>あし
勉強もしないで試験に合格しようなんて、{{c1::むし}}がいい話だ。	むし<br>うま<br>ねこ<br>あじ
相手の気持ちも考えて、なるべく{{c1::かど}}が立たないように、言葉には十分気をつける。	かど<br>かお<br>うで<br>ゆび
試験の当日にかぜで熱が出てしまって、せっかくの努力が{{c1::水の泡}}となってしまった。	水の泡<br>猫の額<br>スズメの涙<br>上の空
授業中は一生懸命、先生の話に{{c1::みみ}}をかたむける。	みみ<br>くび<br>かお<br>はな
山田さんのご主人は、ほんとうにていねいで、だれに対しても{{c1::こし}}が低い。	こし<br>かた<br>あし<br>はな
一人でやりますと言ってしまったので、今更、{{c1::きまりわるくて}}助けてほしいとは言えない。	きまりわるくて<br>せつなくて<br>けむたくて<br>ばかばかしくて
祭の日には色とりどりの{{c1::きらびやかな}}民族衣装を身につけた女達が大勢集まった。	きらびやかな<br>きよらかな<br>だらしない<br>みすぼらしい
映画スターには{{c1::強烈な}}個性を持っている人が多い。	強烈な<br>勤勉な<br>簡素な<br>温和な
救援隊がくるまで、１枚のチョコレートと雨水で{{c1::かろうじて}}生きのびることができた。	かろうじて<br>しいて<br>あえて<br>つとめて
オフィスに{{c1::ちょくちょく}}顔を出していれば、仲良くなって契約がとれるかも知れないよ。	ちょくちょく<br>ぶらぶた<br>ちゃくちゃく<br>ぺこぺこ
ちょっと{{c1::ヒント}}をもらうと問題がすんなりとけることがあります。	ヒント<br>ベスト<br>ゲスト<br>パート
{{c1::気}}が早いですね。もう来週の旅行の準備をしてしまったんですか。	気<br>足<br>耳<br>手
いくらけんかをしても、人間関係を{{c1::そこなって}}しまうようなことを言ってはいけない。	そこなって<br>うるおって<br>つくろって<br>やしなって
小さな会社をはじめたが、経費が{{c1::かさむ}}ばかりでなかなか経営が軌道に乗らない。	かさむ<br>からむ<br>いどむ<br>たるむ
スピード違反の{{c1::取り締まり}}月間だそうで、この間から2度も捕まってしまった。	取り締まり<br>取り調べ<br>取り扱い<br>取り組み
部長は結婚の仲人を快く{{c1::承諾}}してくれた。	承諾<br>了解<br>了承<br>承認
来月末までに新しいビルへの{{c1::移転}}ができます。	移転<br>異動<br>移住<br>異郷
私の理論を{{c1::実現}}に写すための方針は既に考えてあります。	実現<br>実質<br>実施<br>実行
彼は多額の財産を相続することを{{c1::放棄}}したそうだ。	放棄<br>廃棄<br>廃棄<br>廃止
彼は自分の研究論文が認められないので学会を{{c1::脱退}}してしまった。	脱退<br>脱線<br>後退<br>辞退
新しい機械の説明を聞いたが、何度聞いても{{c1::ややこしくて}}よくわからない。	ややこしくて<br>たやすくて<br>なやましくて<br>ものたりなくて
彼は会議ではいつも{{c1::活発に}}発言するが、実行が伴わないからあまり信頼されていない。	活発に<br>頑固に<br>盛大に<br>壮大に
王女の結婚式が長い歴史のある教会で{{c1::おごそかに}}行われた。	おごそかに<br>すこやかに<br>しとやかに<br>おろそかに
その洋服は少し大きすぎないか。なんだか{{c1::だぶだぶ}}した感じがするよ。	だぶだぶ<br>ずるずる<br>ふらふら<br>ながなが
人前に出ると{{c1::おどおど}}してしまうから、営業の仕事なんてとうてい無理だよ。	おどおど<br>どうどう<br>いやいや<br>まちまち
宇宙ロケットで飛び立った飛行士から地球への{{c1::メッセージ}}が送られてきました。	メッセージ<br>コマーシャル<br>コメント<br>モニター
盗んですぐ中古品店に持ち込んだ機械の製造番号から{{c1::足}}がついたらしいですよ。	足<br>鼻<br>目<br>気
異常な悪臭がしたので、鼻を{{c1::つまんで}}逃げた。	つまんで<br>つんで<br>つねって<br>つまって
他人の幸せや昇進を{{c1::ねたむ}}のは見苦しい。	ねたむ<br>はげむ<br>にじむ<br>うながす
一度口に出して言ってしまったことを、いまさら{{c1::取り消そう}}と思っても無理だよ。	取り消そう<br>取り除こう<br>取り戻そう<br>取り替えよう
反対が多いのに、政府はその議案を{{c1::強行}}採決した。	強行<br>無断<br>強硬<br>強制
引っ越し荷物が次から次に{{c1::手際}}良くトラックに載せられていく。	手際<br>手口<br>手分け<br>手配
会社経営の{{c1::実態}}が明らかになるにつれ、負債総額が１０億円以上になることがわかった。	実態<br>態勢<br>事態<br>情勢
洪水で不通になった道路の{{c1::復旧}}作業がなかなかはかどらない模様です。	復旧<br>復活<br>回復<br>復興
彼は{{c1::独創的}}な作品を次々発表して批評家の注目をひいた。	独創的<br>独占的<br>独裁的<br>独自的
梅雨になると曇りや雨の日が多く、{{c1::うっとうしい}}日が続く。	うっとうしい<br>けがらわしい<br>ややこしい<br>わずらわしい
この家は骨組みが{{c1::頑丈}}だから孫の代まで大丈夫だろう。	頑丈<br>強硬<br>巧妙<br>厳密
歌手にしても舞台俳優にしても、きょうの公演は{{c1::完ぺき}}だったと思う日はないそうだ。	完ぺき<br>賢明<br>精巧<br>高尚
彼の自慢話を何度も聞かされて、全く{{c1::うんざり}}だよ。	うんざり<br>げっそり<br>なにより<br>おおげさ
あんなに一生懸命勉強したのに受験に失敗して{{c1::がっくり}}してたよ。	がっくり<br>がっちり<br>がっしり<br>びっしょり
毎日の{{c1::ストレス}}の積み重ねがノイローゼの原因になります。	ストレス<br>ストライキ<br>ボイコット<br>インフレ
甘いものに{{c1::目}}がなくて、つい食べてしまうんですよ。	目<br>足<br>手<br>口
もう{{c1::もがいて}}も仕方がない。やるだけやってあきらめよう。	もがいて<br>すすいで<br>ゆらいで<br>といで
晴れた日に干したふとんをパンパンと{{c1::はたく}}気持ちがいい。	はたく<br>つつく<br>はじく<br>はたす
この机はわざわざ注文してイタリアから{{c1::取り寄せて}}もらったものだ。	取り寄せて<br>取り次いで<br>取り立てて<br>取り付けて
会社の備品を買いたいときは、あらかじめ{{c1::申請}}してください。	申請<br>要請<br>申告<br>要求
会社を成長させるために、古い組織の{{c1::革新}}と管理職の若返りが求められている。	革新<br>変形<br>確信<br>革命
宗教の違う民族との{{c1::共存}}は受け入れられないと主張して戦争を続けている。	共存<br>共同<br>共有<br>共和
履歴書に書かれたこれまでの{{c1::経歴}}が素晴らしいので即座に採用が決まった。	経歴<br>経緯<br>過程<br>経過
国際婦人会議に出席して婦人解放運動に対する{{c1::認識}}を新たにした。	認識<br>意識<br>常識<br>標識
開放政策により中国の経済は{{c1::めざましい}}発展を遂げつつある。	めざましい<br>おびただしい<br>ふさわしい<br>なだかい
私の妻は{{c1::きちょうめん}}だから、毎日、家計簿と日記をつけている。	きちょうめん<br>慎重<br>頑固<br>おくびょう
このソファーに４人座ると、ちょっと{{c1::窮屈}}じゃないかな。	窮屈<br>憂うつ<br>きゃしゃ<br>こっけい
あやふやな言い方をするより、{{c1::きっぱり}}断ったほうがずっと親切だよ。	きっぱり<br>くっきり<br>まるっきり<br>てっきり
あの人は{{c1::あっさり}}した人だから、きちっと誤れば、いつまでも怒ったりしないんだよ。	あっさり<br>こうこうと<br>すんなり<br>まるまる
私たちは{{c1::メディア}}通して世界中の情報を手に入れることができるようになりました。	メディア<br>ビジネス<br>テレックス<br>コメント
旅行でお金を使い過ぎて{{c1::足}}が出てしまった。	足<br>手<br>目<br>顎
国連の重い任務を{{c1::になって}}、戦争をしている国に赴いた。	になって<br>そむいて<br>かばって<br>うながして
子供をそんなに{{c1::せかす}}と危ないですよ、ゆっくり行きましょう。	せかす<br>おかす<br>かわす<br>あかす
人気スターの車が到着すると、どっとファンが{{c1::押し寄せて}}負傷者が出てしまった。	押し寄せて<br>押し込んで<br>押し出して<br>押し入れて
地域を{{c1::開発}}するために必要な多額の資金は税金だけではまかなえない。	開発<br>開拓<br>開放<br>打開
大統領暗殺のニュースが流れると、国民の間に大きな{{c1::衝撃}}が走った。	衝撃<br>攻撃<br>打撃<br>衝突
味方の失敗で、試合はにわかに{{c1::形勢}}不利に陥ってしまった。	形勢<br>形成<br>形態<br>体制
{{c1::発想}}を転換すれば、もう少しおもしろい企画が出せるはずだよ。	発想<br>空想<br>思想<br>愛想
海外に駐在している彼の一時帰国する日が{{c1::まちどうしい}}。	まちどうしい<br>このましい<br>のぞましい<br>せつない
携帯電話の料金は高いから{{c1::緊急の}}用件があるときだけかけるようにしている。	緊急の<br>早急の<br>特急の<br>応急の
先日、見合いをした相手から{{c1::婉曲に}}断りの電話があった。	婉曲に<br>円満に<br>円滑に<br>遠慮に
すがすがしい感じの青年が{{c1::さっと}}立って老人に席をゆずった。	さっと<br>ひょっと<br>ぐっと<br>ずらっと
{{c1::かねて}}より問題になっておりましたゴミ処理場建設地について話し合いたいと思います。	かねて<br>かつて<br>いたって<br>はるか
今日の午後は集会がありますから、次の{{c1::チャイム}}が鳴ったら講堂に集まってください。	チャイム<br>チェンジ<br>キャッチ<br>チャンネル
あの人は{{c1::目}}がきくから、いっしょに買いに行っていただいたらどうですか。	目<br>手<br>頭<br>口
部下を{{c1::けなす}}よりおだてた方が仕事がうまくいきますよ。	けなす<br>まかす<br>けとばす<br>ごまかす
秋は夜が長くなるので、読書に{{c1::したしむ}}季節だと言われています。	したしむ<br>したう<br>つつしむ<br>いとなむ
私たちには古くから伝わる伝統芸能を{{c1::受け継いで}}いく義務がある。	受け継いで<br>受け付けて<br>受け止めて<br>受け入れて
全く彼の疲れを知らないエネルギーには{{c1::圧倒}}されてしまうよ。	圧倒<br>圧縮<br>圧迫<br>抑圧
根気よく障害を{{c1::排除}}する努力を重ねて、協定を結ぶことができました。	排除<br>削除<br>解除<br>除外
家が狭いので古いものはどんどん{{c1::処分}}しないと大変なことになる。	処分<br>処置<br>処罰<br>処理
私のかわりに彼にこの件の最終的な決定をする{{c1::権限}}を与えてあります。	権限<br>権威<br>権利<br>権力
新しいコンピューターを導入したので仕事の{{c1::能率}}ぐんをアップした。	能率<br>比率<br>引率<br>確率
昔、このあたりに{{c1::なさけぶかい}}金持ちがいて、貧しい人達に食べ物を配っていたそうだ。	なさけぶかい<br>なさけない<br>よくふかい<br>こころよい
集団で動くときには、人に迷惑をかけるような{{c1::軽率な}}行動をしてはならない。	軽率な<br>軽快な<br>気軽な<br>手軽な
{{c1::いいかげんな}}話ばかりするので、もう誰も耳を貸そうとしない。	いいかげんな<br>うつろな<br>ろくな<br>ぞんざいな
避難訓練を行いますから非常ベルが鳴ったら{{c1::すみやかに}}外へ出てください。	すみやかに<br>とっさに<br>突如<br>適宜
{{c1::依然}}として、銀行強盗のグループは車で逃走中の模様です。	依然<br>呆然<br>漠然<br>断念
社員研修の{{c1::ムード}}が良かったので明日からが楽しみだ。	ムード<br>フォーム<br>ポーズ<br>ブーム
あの若い社員に社長はずいぶん{{c1::肩}}を入れているらしいよ。	肩<br>目<br>耳<br>手
敵を{{c1::あざむく}}ためには、まず味方をだませと言う言葉があります。	あざむく<br>うつむく<br>おもむく<br>つらぬく
急速なコンピューターの普及は電子部品会社に大きな利益を{{c1::もたらした}}た。	もたらした<br>もてなした<br>もよおした<br>みなした
視聴率が低下したので1年続いたテレビ番組を{{c1::打ち切った}}。	打ち切った<br>打ち明けた<br>打ち消した<br>打ち込んだ
この文章は作者が何を言いたいのか、{{c1::意図}}していることがはっきりしない。	意図<br>意向<br>意欲<br>意識
このたび施行された新制度の{{c1::概略}}を説明させていただきます。	概略<br>概説<br>概論<br>概念
わが社も東南アジアへの{{c1::進出}}を計画している。	進出<br>進呈<br>進展<br>進行
カルシウムが{{c1::欠乏}}すると頭の働きが悪くなるそうです。	欠乏<br>窮乏<br>不十分<br>貧弱
部族によっては信じられないような奇妙な{{c1::風習}}を受け継いでいる。	風習<br>風俗<br>風土<br>風景
イタリアで音楽の勉強をするという計画は父の突然の死により{{c1::はかない}}夢となってしまった。	はかない<br>もろい<br>けむたい<br>たやすい
自らが選んだのなら、誰にも会わない{{c1::孤独な}}生活が必ずしも不幸とは言えない。	孤独な<br>固有な<br>個別な<br>独自な
旅行先で出会った幼い子供の{{c1::つぶらな}}目が忘れられない。	つぶらな<br>あざやかな<br>なごやかな<br>こまやかな
彼は何をきいても{{c1::即座に}}答えてくれる天才的な頭脳の持ち主だ。	即座に<br>不意に<br>ひょっと<br>ちらっと
私が{{c1::いかに}}がんばっても、彼にはとうてい追い付けない。	いかに<br>むやみに<br>いやに<br>やけに
新しい原子力発電所の原子炉は{{c1::トラブル}}が多くてなかなか役に立たない。	トラブル<br>ファイト<br>サイクル<br>アクセル
あの人は{{c1::舌}}が肥えているから、どんなもてなしをしたらいいか悩むよ。	舌<br>体<br>耳<br>目
近年の不況と円高は、輸出関連企業の経営を{{c1::おびやかして}}いる。	おびやかして<br>おだてて<br>おどして<br>ひやかして
彼は悲しみの中で、なくなった母に{{c1::ささげる}}歌を作曲した。	ささげる<br>さえずる<br>さえぎる<br>さずける
学校からの帰宅途中、駅前の本屋に{{c1::立ち寄る}}のが何よりの楽しみでした。	立ち寄る<br>立ち止まる<br>立ち上がる<br>立ち去る
航空会社の社員募集があったのですぐに{{c1::応募}}した。	応募<br>応接<br>応対<br>会見
あなたの主張は時代{{c1::錯誤}}もはなはだしいと思います。	錯誤<br>格差<br>誤差<br>差別
平和的解決の{{c1::使命}}を帯びて、大使は現地に赴いた。	使命<br>任命<br>宿命<br>運命
戦後５０年たって、当時の秘密資料が続々{{c1::公表}}されはじめました。	公表<br>公開<br>公認<br>公然
営業{{c1::妨害}}になるので入り口に車を止めないでください。	妨害<br>迫害<br>被害<br>災害
建設現場で働いているから性格は{{c1::あらっぽい}}けれど、とても優しい父です。	あらっぽい<br>あくどい<br>すばしこい<br>すばやい
契約の{{c1::詳細な}}内容については後日担当者がご説明にまいりますのでよろしくお願いします。	詳細な<br>相応な<br>正当な<br>精密な
社内で誰も知らないと思うけれど、あの人{{c1::ひそかに}}株でもうけているらしいわよ。	ひそかに<br>おおげさに<br>こまやかに<br>おおはばに
学校の成績が悪いからといって、{{c1::一概に}}将来の見通しが暗いとは言えない。	一概に<br>てんで<br>ろくに<br>もろに
まだもう少し入院が必要らしいが、手術後の経過は{{c1::さほど}}悪くないらしいよ。	さほど<br>よほど<br>若干<br>少々
指揮者がうまく{{c1::リード}}してくださるので合唱団の実力以上の公演ができた。	リード<br>ソフト<br>ハード<br>ベース
あの人は取引先が倒産したせいで{{c1::首}}が回らなくなっているらしいよ。	首<br>頭<br>手<br>目
{{c1::ありふれた}}お世辞をいくら言ってもだめなものはだめです。	ありふれた<br>あやまった<br>あつらえた<br>あらたまった
最近、競馬を楽しむ女性が多くなったが、どの馬が１位になるか{{c1::あてる}}のは難しい。	あてる<br>あせる<br>はえる<br>さえる
忘れ物をしたので{{c1::引き返そう}}として踏切事故にあったようです。	引き返そう<br>引き止めよう<br>引き起こそう<br>引き取ろう
前回出版したときの内容に少し手を加えて、{{c1::改訂}}版として出版しようと思います。	改訂<br>改善<br>改良<br>改正
クイズ番組に出演して賞金１０万円を{{c1::獲得}}した。	獲得<br>捕虜<br>確保<br>収穫
{{c1::言論}}の自由が保障されているからと言って、何でも報道していいわけではない。	言論<br>世論<br>弁論<br>理論
我が社も海外進出をすることになり、英会話能力の必要性を{{c1::痛感}}している。	痛感<br>直感<br>反感<br>共感
被害にあった地域に物資を{{c1::補給}}する経路があちこち普通になっている。	補給<br>補足<br>補償<br>補充
冬に、{{c1::ぬるい}}スープなんてとても飲めない。	ぬるい<br>みにくい<br>あくどい<br>きまりわるい
病気で１か月入院すると、健康のありがたさを{{c1::痛切に}}感じるようになった。	痛切に<br>手近に<br>陰気に<br>安易に
最近、放火が多いので{{c1::不審な}}人物を見かけたら警察に連絡してください。	不審な<br>不振な<br>不明な<br>不良な
忙しくて料理ができないから、最近は{{c1::もっぱら}}外食ですませている。	もっぱら<br>もろに<br>ことごとく<br>まるごと
まだ全員集まっていないようですが、{{c1::とりあえず}}きょうの日程の説明を始めたいと思います。	とりあえず<br>もしかして<br>ことによると<br>おのずから
{{c1::インテリ}}風な感じの男性だったのでつい信用してだまされてしまった。	インテリ<br>エレガント<br>ナンセンス<br>シック
子供がいうことをきかないので{{c1::手}}を焼いています。	手<br>胸<br>胃<br>顔
彼はスタイルのも顔もいいし、その上仕事ができるんだから{{c1::もてて}}当然だよね。	もてて<br>もうけて<br>もれて<br>もめて
若い人を育てようと思ったら、失敗をひとつひとつ{{c1::とがめて}}はいけない。	とがめて<br>のがれて<br>となえて<br>なだめて
体の調子が悪いので、今回のマラソン大会に参加するのは{{c1::見合わせよう}}と思います。	見合わせよう<br>見落とそう<br>見渡そう<br>見逃そう
あのあたりは交通量が多いので、今、{{c1::拡張}}工事のために交通規制をしているよ。	拡張<br>拡散<br>拡充<br>拡大
国自体が財政的{{c1::危機}}に直面している。	危機<br>危険<br>危害<br>禁物
今、国会で予算案を{{c1::審議}}しているところです。	審議<br>論議<br>討議<br>協議
あとで後悔しないように、職業の{{c1::選択}}は慎重にしたほうがいいよ。	選択<br>採決<br>選考<br>採択
姉は、外出するとき{{c1::介護}}が必要な障害者を助ける奉仕活動をしている。	介護<br>看護<br>保護<br>養護
おもしろくなさようなところを見ると、この仕事は彼には{{c1::ものたりない}}のかも知れない。	ものたりない<br>おっかない<br>いやらしい<br>みぐるしい
{{c1::善良な}}市民の一人ですと言いながら、裏で業者から多額の現金を受け取る議員を許せない。	善良な<br>清純な<br>賢明な<br>明瞭な
北海道の開拓をさせられた人達は、寒さの中で食べ物もなく、{{c1::悲惨な}}生活を強いられた。	悲惨な<br>冷酷な<br>貧弱な<br>冷淡な
こんなに客が少なくなってしまっては、{{c1::いっそ}}商売をやめたほうがましだ。	いっそ<br>ずばり<br>きちっと<br>ちゃんと
彼が{{c1::いかにも}}おいしそうに食べるので、私もつい食べ過ぎてしまった。	いかにも<br>まことに<br>まさしく<br>はなはだ
その関係の書類ならひとつにまとめて{{c1::ファイル}}に入れてあります。	ファイル<br>タイトル<br>カルテ<br>データ
たくさんの女子社員の中から彼女を選ぶなんて君は{{c1::目}}が高いね。	目<br>鼻<br>頭<br>足
旅行に出る前の晩にはしっかり準備を{{c1::ととのえて}}から寝る。	ととのえて<br>おとろえて<br>とどこおって<br>しなびて
久し振りに郷里に帰ったら、すっかり駅が新しくなっていて{{c1::まごついて}}しまった。	まごついて<br>まぎれて<br>むらがって<br>ふくれて
この部屋なら学生には{{c1::申し分}}ないと思いますよ。	申し分<br>申し訳<br>申し込み<br>申出
この作家は短い文の中に要点がきちんとまとめられた{{c1::簡潔}}で美しい文章を書きます。	簡潔<br>簡易<br>簡素<br>簡単
時折、{{c1::原点}}に立ち返って、平和運動を見直すことが肝心です。	原点<br>視点<br>観点<br>頂点
他店に{{c1::対抗}}して売上をあげるためには営業時間の延長が不可欠です。	対抗<br>抵抗<br>反抗<br>抗争
{{c1::資金}}の運用をあやまって、会社を倒産させてしまった。	資金<br>資本<br>資源<br>資産
判決に{{c1::不服}}があれば、上級の裁判所に訴えることができる。	不服<br>不審<br>不正<br>不振
やはり棚はもっと{{c1::たいらな}}ところに置かないと安定しなくて危ないよ。	たいらな<br>ひさしい<br>しかくい<br>まんまるい
{{c1::肝心な}}ことはあなたに本当にこの仕事をやる気があるかどうかです。	肝心な<br>簡潔な<br>正当な<br>勝手な
真面目で{{c1::誠実な}}方なので結婚しようと決めました。	誠実な<br>忠実な<br>滑けいな<br>正常な
{{c1::とかく}}この世の中は住みにくいと言うが、結構、楽しいこともある。	とかく<br>とりわけ<br>ことに<br>まして
最近の子供は両親や祖父母に{{c1::ちやほや}}されて育つので自己中心的になりがちです。	ちやほや<br>あやふや<br>あべこべ<br>めちゃくちゃ
この服は{{c1::デザイン}}も色も素敵だなと思うと、高くて手が出ないことが多い。	デザイン<br>デザート<br>レッスン<br>デッサン
次から次に子供に教育費がかかって、全く{{c1::頭}}が痛いよ。	頭<br>耳<br>胸<br>腹
帰宅したら自分の部屋に{{c1::こもって}}、テレビｹﾞｰﾑに熱中している。	こもって<br>こって<br>こりて<br>うまって
目を{{c1::つぶる}}と、幼い日に遊んだふるさとの情景が目に浮ぶ。	つぶる<br>にぶる<br>ねだる<br>たどる
道がカーブしている上に強い雨のせいで{{c1::見通し}}が悪く、運転は危険な状況だった。	見通し<br>見積もり<br>見込み<br>見晴らし
この会社では毎年1月1日は全員出社して、新年の挨拶をするのが{{c1::慣例}}になっている。	慣例<br>定例<br>習慣<br>家風
裏面に{{c1::記載}}されている注意事項をよく読んでおいてください。	記載<br>掲載<br>記述<br>記録
デパートやスーパーにはいくつもの防犯カメラが{{c1::設置}}してあります。	設置<br>措置<br>処置<br>装置
彼は不正を暴露され{{c1::失脚}}してしまった。	失脚<br>失格<br>失調<br>失望
地域住民の{{c1::要望}}により高速道路の騒音防止対策委員会が発足した。	要望<br>祈願<br>用命<br>救済
成田空港に着いたとき、友人が迎えにきてくれたので本当に{{c1::こころづよくて}}助かった。	こころづよくて<br>このましくて<br>こころよくて<br>こころぼそくて
山奥の温泉宿は静かで、土地の人達は{{c1::素朴}}で都会か来た客に優しかった。	素朴<br>単調<br>無難<br>簡素
判断の基準が違う外国との交渉に臨むときには、特に{{c1::柔軟な}}姿勢が必要とされる。	柔軟な<br>自在な<br>健全な<br>円満な
あのお宅は、{{c1::時折}}話し声がすることもありますが、普通は留守がちですよ。	時折<br>しょっちゅう<br>頻繁に<br>たいがい
{{c1::せんだって}}お約束した件について、もう一度ご相談したいと思います。	せんだって<br>さきに<br>かつて<br>まえもって
部屋の鍵はホテルの{{c1::フロント}}で受け取ってください。	フロント<br>コーナー<br>ケース<br>スペース
ここはひとつ私の{{c1::顔}}を立てて許してやってください。	顔<br>腹<br>腕<br>気
１度や２度{{c1::しくじった}}からといって、あきらめるのはまだ早いよ。	しくじった<br>さとった<br>いじった<br>ののしった
古いアルバムを{{c1::めくる}}と、写真の１枚１枚に思い出がつまっていて懐かしい。	めくる<br>むしる<br>とじる<br>しみる
もう子供ではありませんから私の保護者のように{{c1::振る舞う}}のはやめてください。	振る舞う<br>振り向く<br>振り出す<br>振り返る
あの女優は{{c1::気品}}があるから、今度の映画作品の主人公に選ばれた。	気品<br>気風<br>気質<br>気立て
{{c1::規律}}ある生活をするようにl心掛けて暮しています。	規律<br>規則<br>規約<br>規範
各国間の意見の{{c1::調整}}に時間がかかって、なかなか声明が発表できない。	調整<br>調停<br>調和<br>調印
会社の{{c1::収益}}の一部で車椅子を購入し、障害者の施設に寄付した。	収益<br>収穫<br>収集<br>収支
彼は会社に忠実でまじめな{{c1::模範}}的社員だったのに、すっかり変わってしまった。	模範<br>規模<br>模倣<br>模様
近年、東南アジアの経済の発展は{{c1::いちじるしく}}、日本の企業もたくさん進出している。	いちじるしく<br>おびただしく<br>はなばなしく<br>ややこしく
毎日の基本練習を{{c1::おろそかに}}すると、決してプロとして良い成績を残すことはできない。	おろそかに<br>うつろに<br>おろかに<br>ばかばかしく
社員研修の{{c1::おおまかな}}日程が決まりましたので発表します。	おおまかな<br>こまやかな<br>おおはばな<br>おおがらな
別れてしまった人に、{{c1::いまさら}}愛していますとは言いにくい。	いまさら<br>いまだ<br>もはや<br>なおさら
お忙しいとおもいますが、当日はご参加くださいますように{{c1::なにとぞ}}よろしくお願い致します。	なにとぞ<br>なるたけ<br>ひいては<br>ひたすら
私なんて会社という大きな{{c1::システム}}の歯車の一つでしかない。	システム<br>ポイント<br>ポジション<br>セクション
いまどき、{{c1::おご}}でひとを使ったりしては、若い者はやめてしまいますよ。	おご<br>目<br>顔<br>足
３日前に海で遭難した人を乗せた救命ボートが{{c1::ただよって}}いるのが見つかった。	ただよって<br>うかって<br>とろけて<br>さぼって
今、外国企業との技術提携の準備に{{c1::たずさわって}}いるので、とてもほかまで手が回らない。	たずさわって<br>たてまつって<br>つかさどって<br>たまわって
大学受験２か月前ともなると勉強も{{c1::追い込み}}に入ります。	追い込み<br>追い出し<br>追いつき<br>追い越し
オリンピックのために{{c1::壮大な}}規模の競技場が建設されました。	壮大な<br>膨大な<br>拡大な<br>盛大な
新しい会社を設立する{{c1::構想}}を練っているところです。	構想<br>機構<br>構造<br>構成
東京の中心部では住民の減少により、小学校の{{c1::統合}}が相次いでいる。	統合<br>統治<br>統制<br>統率
{{c1::推測}}でものを判断すると大変な間違いを犯す。	推測<br>推理<br>推定<br>推進
最近は化学肥料を使わない{{c1::有機}}農業というものが見直されている。	有機<br>有益<br>有望<br>有能
台風のせいで{{c1::おびただしい}}量の土や砂が上流から流れてきた。	おびただしい<br>ばかばかしい<br>いちじるしい<br>まぎらわしい
{{c1::不意に}}飛び出してきた子供を危うく車ではねるところだった。	不意に<br>身近に<br>無邪気に<br>早急に
親にうそをつくような子供は{{c1::ろくな}}人間になれないと父に厳しく叱られた。	ろくな<br>おろかな<br>寛容な<br>好評な
{{c1::なんだか}}きょうはひどく機嫌がいいですね、何か良いことがあったんですか。	なんだか<br>どうやら<br>どうにか<br>なんなり
きょうは風雨が強くなるそうだ。{{c1::ことによると}}野球の試合は中止になるかも知れないね。	ことによると<br>しかしながら<br>案の定<br>にもかかわらず
外国人のスピーチ{{c1::コンテスト}}があるので一生懸命暗記しています。	コンテスト<br>コントラスト<br>コンタクト<br>コントロール
政治運動に{{c1::首}}を突っ込みすぎて、家庭が崩壊してしまった・	首<br>顔<br>足<br>頭
体の調子が良いと、どんどん仕事が{{c1::はかどる}}。	はかどる<br>たばねる<br>またがる<br>ゆさぶる
肉体的、精神的に余裕がないと他人を{{c1::いたわる}}やさしさを失いがちである。	いたわる<br>あやまる<br>あやつる<br>おしむ
長い間住み慣れた土地には{{c1::未練}}が残る。	未練<br>未定<br>未知<br>未熟
その喫茶店を探すときは何か{{c1::目印}}となるような建物がありますか。	目印<br>目安<br>目途<br>目付き
東京都はゴミの{{c1::分別}}収集を徹底するために透明ゴミ袋をくばった。	分別<br>個別<br>区別<br>差別
会議の前に{{c1::配布}}した資料に目を通しておいてください。	配布<br>配分<br>配達<br>配列
{{c1::所定}}の用紙に必要事項を書いて３番の窓口に提出してください。	所定<br>所属<br>所在<br>所持
行政が福祉施設に補助金を出すことは消費者に税金を{{c1::還元}}することと言える。	還元<br>返済<br>弁償<br>返還
目的もなく、ただ時間に追われて仕事をする忙しい生活を{{c1::むなしく}}感じる。	むなしく<br>みぐるしく<br>はかなく<br>たやすく
こんな{{c1::貧弱}}な内容のレポートでは合格はおぼつかない。	貧弱<br>不吉<br>小柄<br>簡易
崩壊したビルの現場から{{c1::かすかな}}助けを呼ぶ声が聞こえて､救助作業が再開された?	かすかな<br>はるかな<br>ひそかな<br>しとやかな
{{c1::いざ}}ハイキングに出かけようというときに雨がぽつぽつ降り出してしまった。	いざ<br>さも<br>さぞ<br>なんか
水曜日{{c1::もしくは}}金曜日のどちらかの午前中にお越しください。	もしくは<br>ならびに<br>およびに<br>かつ
コンサートが素晴らしかったので{{c1::アンコール}}を求める拍手が鳴り止まなかった。	アンコール<br>アンケート<br>アルコール<br>アプローチ
組合運動をやり過ぎて、とうとう会社を{{c1::首}}になってしまった。	首<br>気<br>顔<br>手足
自動販売機の普及により、女性社員が休憩時間のお茶を配る習慣が{{c1::すたれ}}つつある。	すたれ<br>ほころび<br>ほどこし<br>ほろび
目の見えない人を目的地まで安全に{{c1::みちびく}}犬のことを盲導犬という。	みちびく<br>ひきずる<br>うながす<br>ひきいる
あと一歩というところで優勝を逃してしまい{{c1::無念}}でなりません。	無念<br>無闇<br>無能<br>無口
最後まで{{c1::意地}}を張り通してしまうと、気まずい関係になるよ。	意地<br>熱意<br>意志<br>決意
会社に貢献した{{c1::業績}}が認められて管理職に昇進した。	業績<br>効能<br>名誉<br>能率
子供を相手に{{c1::本気}}でけんかをするなんて頭がおかしいんじゃないですか。	本気<br>本能<br>本質<br>本音
街頭デモを{{c1::阻止}}しようとする警官が参加者を数人逮捕したらしい。	阻止<br>停止<br>中止<br>禁止
円滑な人間関係を保ちたいという考えが{{c1::根底}}にあるから、贈り物をするのだろう。	根底<br>根本<br>根気<br>根拠